阿城	ACB
阿达日嘎	AEC
阿达日格	ARC
阿尔乡	ARD
阿金	AJD
阿拉沟	ALR
阿里河	AHX
阿龙山	ASX
阿木尔	JTX
阿南庄	AZM
阿乌尼	AWX
阿寨	AAW
阿贵图	AGC
艾比湖	AHR
艾不盖	ABC
埃岱	ADW
艾河	AHP
爱河	AHB
艾家村	AJJ
隘口	AKZ
艾田	ATW
艾友营	AYD
阿克苏	ASR
阿克陶	AER
阿拉山口	AKR
安北	ABR
安边	ABW
安柴	ACK
安达	ADX
安德	ARW
安定	ADP
安多	ADO
安福寺	AFN
安富镇	AZW
安广	AGT
安化	PKQ
安华	AHH
安集海	AJR
安家	AJB
安家湾	AJW
安靖	PYW
安居	AJC
安康	AKY
安康东	ADY
安口窑	AYY
安龙	AUZ
安陆	ALN
安民	ANT
安平	APT
安庆	AQH
安庆北	ABH
安庆沟	AQD
安庆西	APH
鞍山	AST
岸山	ASZ
鞍山西	AXT
安恕	ATT
安顺	ASW
安太堡	APV
安塘	ATV
安亭	ATH
安亭北	ASH
安图	ATL
安溪	AXS
安阳	AYF
安阳东	ADF
安阳西	AXF
安邑	AYV
安远镇	AXJ
安子沟	AZY
昂昂溪	AAX
昂乃	AND
敖包沟	AOC
敖汉	AHD
鳌江	ARH
敖来	AID
坳上	ASQ
敖头	ATB
阿图什	ATR
阿尔山	ART
阿尔山北	ARX
巴楚	BCR
八村	BVX
八达沟	BVB
八大家	BDN
八达岭	ILP
八道壕	BDD
巴东	BNN
八斗	BDZ
八陡	BDK
八都	BUG
八渡	BWZ
八方	BAX
巴哥	BGR
拔贡	BGZ
巴关河	BHW
巴关岭	BLZ
八虎力	BUB
巴胡塔	BHD
把集	BGG
八家子	BZL
八角台	BTD
八景	BAG
八棵树	BKR
八里	CPW
八里湾	BVH
八里庄	BLP
坝梁	BLC
巴林	BLX
八面城	BMD
八面通	BMB
八庙	KBW
八盘磨	BMR
扒挪块	BKW
八盘峡	BPJ
灞桥	BQY
巴日图	BRX
巴山	BAY
八苏木	BSC
巴图塔	BWC
鲅鱼圈	BYT
巴中	IEW
霸州	RMP
白壁关	BGV
白城	BCT
柏村	BCW
白村	BCY
白洞	BDA
白墩子	BZJ
百股	BGD
白果	BIW
柏果	BGM
白海	BIT
白合	BHF
白河	BEL
白鹤隘	BAZ
白河东	BIY
白鹤岭	BHH
白河县	BEY
白桦排	BPX
白芨沟	BJJ
白鸡坡	BBM
柏家	BBB
白家店	BJK
白涧	BAP
白奎堡	BKB
白狼	BAT
百浪	BRZ
百里村	BCZ
百里峡	AAP
柏林	BLW
白龙桥	BUH
白鹿塘	BLH
白马	KMW
白马厂	BCK
白马垅	BMQ
白旗	BQP
白泉	BQL
百色	BIZ
白沙	BSW
白沙冲	BCM
白沙坡	BPM
白沙沱	BXW
柏山	BSF
白山市	HJL
白山乡	BSX
白市	BAD
白石山	BAL
白石岩	BOW
白市驿	BDW
白水	BUW
白水河	BVZ
白水江	BSY
白水镇	BUM
白塔	BOC
白塔村	BTM
白塔工交场	BTI
白涛	BNW
白田	BTG
白土梁	BTJ
白彦花	BHC
白杨畈	BFG
白杨河	BIJ
白音胡硕	BCD
白音库伦	BUC
白银市	BNJ
白音特拉	BRC
白银西	BXJ
白源	BYG
白云	BVD
白庄	BIP
百子湾	BWP
八仙筒	VXD
巴伦台	BNR
半边街	BQW
板城	BUP
半截河	BHB
班猫箐	BNM
板其	BQZ
板桥	BQH
板杉铺	BSG
板石河	BNL
板桃	BUZ
坂田	BTQ
坂尾	BWS
板杖子	BCL
斑竹园	BYW
保德	BAV
宝坻	BPP
保定	BDP
保定东	BMP
报恩寺	BEW
包尔海	BRR
包官营	BGP
褒河	BHY
宝华山	BWH
宝鸡	BJY
宝鸡南	BBY
保家楼	BJW
保健	BPC
宝镜	BJT
保康	BKD
宝拉格	BQC
宝老山	BRW
宝莲寺	BLF
宝林	BNB
宝龙山	BND
宝门乡	BOT
宝木吐	BMC
宝清	BQA
宝泉岭	BQB
宝山	BOL
雹神	BSD
堡石图	PSD
包头	BTC
包头北	BBC
包头东	BDC
包头西	BXC
包头西乘降	BCC
鲍峡	BXN
宝秀	BAM
葆园	BYL
堡子湾	PZC
巴彦高勒	BAC
巴彦郭勒	BGC
白银哈尔	BIC
白云鄂博	BEC
白音察干	BYC
白音他拉	BID
北安	BAB
北白	BBV
北板桥	BBF
北碚	BPW
北仓	BCP
北戴河	BEP
北磴	BBD
北甸	BDT
北斗	BRQ
北甘旗	BQD
北岗	BGL
北海	BHZ
北河	BHJ
北河店	BHP
北湖	BUD
北集坡	BPK
卑家店	BBP
贝江	BJZ
北	IBQ
北郊	BCH
北京	BJP
北京北	VAP
北京东	BOP
北京南	VNP
北京西	BXP
背开柱	BAW
北林	BEB
北流	BOZ
北六堡	BUV
北刘庄	VLP
北仑	VOH
北马圈子	BRP
北牟	BVK
滥菊	BZW
北票	BPD
北票南	RPD
北千里	BNX
北绕阳	BYD
北三家	BET
北舍	BNP
北师店	BHK
北台	BTT
北台子	BWD
北塘	BTP
北塘西	BFP
北田受	BTV
北头河	BTX
北屯	BYP
北屯市	BXR
北辛堡	BXV
北兴安	BNT
北义井	BYV
背荫河	BYB
北营	BIV
北园	BYK
北宅	BVP
北召店	BZF
薏	FWH
贲红	BVC
本井	BJC
本溪	BXT
本溪湖	BHT
蚌埠	BBH
蚌埠南	BMH
碧鸡关	BJM
毕家岗	BJH
毕家圈	BJA
笔架山	BSB
碧江	BLQ
毕克齐	BKC
碧石渡	BSN
碧水	BUX
碧州	BOX
边沟	BKT
边昭	BZT
别山	BSP
滨海	FHP
滨海北	FCP
彬江	BJG
滨江	BJB
冰草湾	BWJ
冰沟	BGJ
丙谷	BVW
兵马营	VMP
博鳌	BWQ
渤海	BED
博乐	BOR
勃利	BLB
玻璃山	BOD
波罗赤	BLD
博罗东	BFQ
播明	BMV
博山	BSK
泊头	BZP
博兴	BXK
亳州	BZH
波洲	BZQ
布敦化	BFD
布尔加依	BJR
布海	BUT
卜家沟	BWY
布列开	BLR
埠西头	BTK
步行街	BWW
博克图	BKX
擦耳	KFW
蔡家	CAT
蔡家沟	CJT
蔡家坡	CJY
蔡家庄	CZK
蔡山	CON
采石场	CIL
蔡寨	CFK
蚕厂屯	CUT
沧波门	CMH
仓房	CFM
沧口	CKK
苍南	CEH
苍坪	CEW
苍山	CSX
仓山镇	KVW
苍石	CST
沧州	COP
沧州西	CBP
草坝	CBM
草坂	CBS
曹村	CCK
草店	CDF
曹东庄	CJP
草海	WBW
漕河	CEP
草河口	CKT
曹家坝	CVY
曹家伙场	CCY
曹家堡	CJO
曹家湾	FWW
曹家营子	CVD
漕泾	CPH
曹老集	CLH
草六格尔	CRC
草庙子	CAK
曹浦	CPK
草市	CSL
曹王	CWK
曹县	CXK
曹庄	CWP
曹子里	CFP
册亨	CHZ
策达雅	CYR
岑溪	CNZ
查班河	CBX
查布嘎	CBC
叉车厂	CIT
茶淀	CVP
查干得日斯	CPC
查干哈达	CDC
查干芒和	CMC
叉沽港	GHP
察汗诺	CHO
岔河	CKW
岔江	CAM
茶陵	CDG
茶山	CFQ
岔滩	CTW
茶条沟	CTL
茶亭	CTI
茶坞	CWV
岔西滩	CXJ
查岩	CYZ
茶园	CYQ
茶镇	CEY
柴岗	CGT
柴沟堡	CGV
柴河	CHB
柴凯	COO
柴窝堡	CPR
柴西	CXR
柴庄	CZV
馋口	CKJ
茶山坳	CAQ
长安集	CYH
长安镇	CAH
长城	CEJ
长城梁	CCV
长冲	CCM
长春	CCT
长春东	COT
长春南	CET
长春西	CRT
常村	VCP
常德	VGQ
常德东	VKQ
常德西	VZQ
长甸	CDT
长发	CFT
长发屯	CFB
长丰	CCQ
长岗	CGL
长岗集	CGH
长岗岭	CIZ
长葛	CEF
厂汗	CHC
长河坝	CAW
长河碥	CHW
长虹	CHT
昌吉	CJR
长基	CJS
常家	CJV
长江埠	CFN
昌乐	CLK
昌黎	CLP
长岭岗	CLN
长岭子	CLT
长流水	CLJ
长宁堡	CBO
长农	CNJ
昌平	CPP
常平	DAQ
昌平北	VBP
长坡岭	CPM
长庆	CQS
长沙	CSQ
长沙坝	CBY
长沙埂	CSW
长沙南	CWQ
长沙堡	CSK
长沙西	RXQ
长山	CAZ
长山村	CCL
长山堡	CBL
长山屯	CVT
长哨	ESY
长胜	CEL
长胜沟	CGW
长寿	EFW
长寿北	COW
长潭沟	FCW
长塘	CTZ
长汀	CES
长汀镇	CDB
昌图	CTT
昌图西	CPT
长辛店	CXP
常兴	CXY
长兴	CBH
长兴南	CFH
长阳	CYN
长垣	CYF
长畛	CQV
长征	CZJ
长治	CZF
长治北	CBF
常州	CZH
常州北	ESH
常庄	CVK
长子	ECF
潮安	CMQ
巢北	ICH
朝查	CCX
朝格温多尔	CWC
巢湖	CIH
超梁沟	CYP
炒米店	CMK
潮莫	CMX
朝脑沟	CAC
潮汕	CBQ
潮水	CUB
朝天	CTY
朝阳	CYD
潮阳	CNQ
朝阳川	CYL
朝阳村	CUX
朝阳地	CDD
朝阳南	CND
朝阳镇	CZL
朝原	CYX
朝中	CZX
潮州	CKQ
察尔汗	CRO
车墩	MIH
车岗	CGQ
车家营子	CRD
车转湾	CWM
陈官营	CAJ
陈家沟	CAV
陈家河	CHN
陈家湖	CJN
谌家矶	CSN
陈家台	CVQ
陈家疃	COK
陈家湾	CWW
陈江	CJQ
晨明	CMB
辰清	CQB
陈塘庄	CTP
辰溪	CXQ
陈相屯	CXT
郴州	CZQ
郴州西	ICQ
承安铺	CAP
程村	CCZ
承德	CDP
承德东	CCP
成都	CDW
成都东	ICW
成都南	CNW
成都中心	CDA
成高子	CZB
呈贡	CGM
城固	CGY
程家	CUP
程家庄	CJK
城口	CKS
澄迈	CRQ
城门	CMS
成团	CUZ
城厢	CFW
城阳	CEK
城子坦	CNT
赤壁	CBN
赤壁北	CIN
赤峰	CFD
赤峰东	CUD
赤峰西	CID
池河	CHY
赤水	CSY
池州	IYH
重庆	CQW
重庆北	CUW
重庆东	CIW
重庆南	CRW
重庆西	CXW
崇仁	CRG
崇信	CIJ
崇左	CZZ
初城	CEQ
褚家湾	CWJ
楚山	CSB
楚雄	COM
楚雄西	COV
滁州	CXH
滁州北	CUH
川山坪	CHQ
川水	CIQ
穿心店	CVW
串子沟	CZD
创业村	CEX
春风	CFJ
纯化	CDK
春申	CWH
春亭阁	CGX
春湾	CQQ
春阳	CAL
茨坝	CBW
慈城	CCH
茨冲	CCW
慈湖	CHH
磁涧	CIF
慈利	CUQ
磁山	CSP
磁西	CRP
磁县	CIP
磁窑	CYK
瓷窑湾	CYC
慈义	CYG
翠峰	CFX
翠岗	CIX
翠亨	IHQ
崔黄口	CHP
崔家营子	CZT
翠峦	CLB
崔马庄	VZP
崔马庄所	01A
翠屏山	CPV
崔寨	CZI
大安	RAT
大安北	RNT
大巴	DBD
大坝	DBJ
大板	DBC
达板城	DCR
大保当	DDY
大毕庄	RBP
大步	DBR
打柴沟	DGJ
大厂县	REP
大成	DCT
大城子	DCP
大川	DCL
大德	DEM
大磴沟	DKJ
大甸	DDD
大东	DDL
大渡口	DKW
达盖	DAC
大岗	DGG
大港	DGK
大姑家	DGL
大关	RGW
大关冲	DCW
大观岭	DOB
大官屯	DTT
大河坝	DIW
大黑山	DNL
大红旗	DQD
大湖	DPH
大虎山	DHD
大荒地	DVD
大灰厂	DHP
达家沟	DJT
大涧	DFP
大旧庄	DJM
大苴	DIM
大觉寺	DLP
大口钦	DKL
大口屯	DKP
大昆仑	DKK
打括	DOW
达拉滨	DFX
打拉亥	DHC
达拉特西	DNC
大理	DKM
大荔	DOY
大理北	DYM
大理东	DLF
大梨树	DRL
大栗子	DLL
大连	DLT
大连北	DFT
大良	DAX
大林	DLD
大岭	DOZ
大刘家	DBT
大陆号	DLC
大米溪	DMY
大民屯	DMX
大拟	DNZ
大盘石	RPP
大平房	DPD
大堡	DVT
大埔	DPI
大其拉哈	DQX
大桥	DQL
大庆	DZX
大青沟	DSD
大庆西	RHX
大泉	DQR
达日其嘎	DQC
大溶江	DRZ
大山铺	DSW
大深	DSS
大石桥	DQT
大石头	DSL
大石寨	RZT
大石庄	RSV
大树湾	DSC
大松树	DUM
大台	DBP
大滩	DTY
大塘	DNM
大田边	DBM
大同	DTV
大同东	DDV
大同南	DIV
大同县	DFV
大土	DTW
大土山	DTD
大屯	DNT
大湾	DMW
大湾子	DFM
大王滩	DZZ
大武口	DFJ
大乌苏	DWX
大西	DXB
大西一场	DXI
大仙	RXT
大辛庄	DXF
大兴	DXX
大兴沟	DXL
大兴镇	DZL
大徐屯	DWD
大雅河	DDT
大雁	DYX
打羊	RNW
大阳岔	DWL
大扬气	DKX
大杨树	DUX
大杨树东	RYX
大洋洲	DZG
大英	PNW
大营	DYV
大英东	IAW
大营镇	DJP
大营子	DZD
大用	DUW
大元	DYZ
大寨	DZW
大战场	DTJ
大杖子	DAP
大郑	DAT
达州	RXW
达州东	DHW
大竹园	DZY
大足	RIW
带岭	DLB
代马沟	DUB
代湾	DWW
待王	DWF
代县	DKV
岱岳	RYV
达拉特旗	DIC
丹东	DUT
丹凤	DGY
丹水池	DCN
丹徒	RUH
丹阳	DYH
丹阳北	EXH
儋州	DNQ
党家庄	DJK
砀山	DKH
当雄	DAO
当阳	DYN
党峪	RIP
道德	DCC
刀尔登	DRD
道口	DKD
道老杜	DED
道劳杜	DBX
道仑郭勒	DEC
道清	DML
道镇	DSY
道州	DFZ
大罕	DAD
德安	DAG
德伯斯	RDT
德惠	DHT
德惠西	DXT
德清	DRH
德清西	MOH
德仁	DEX
德胜	DEZ
得胜村	DCD
得胜台	DET
德阳	DYW
德州	DZP
德州东	DIP
德令哈	DHO
邓家湾	REW
登沙河	DWT
灯塔	DGT
登瀛崖	DNW
邓州	DOF
得耳布尔	DRX
德日斯图	DRC
滴道	DDB
滴台	DKT
低窝铺	DWJ
低庄	DVQ
电白	DEQ
甸苴坝	DVM
店坡	DSV
甸心	DXM
刁家段	DDC
定边	DYJ
丁家滩	DPP
丁家营	DJN
丁家园	DIT
定南	DNG
定陶	DQK
定西	DSJ
定襄	DXV
定兴	DQP
定远	EWH
定州	DXP
定州东	DOP
定州西	DZA
东安	DAZ
东安东	DCZ
东边井	DBB
东大坝	DUD
东大道	DOD
东二道河	DRB
东方	UFQ
东方红	DFB
东丰	DIL
东丰北	DBL
东富	DUL
东阜新	DFD
东宫	DGX
东沟门	DGD
东莞	RTQ
东莞东	DMQ
东光	DGP
东海	DHB
东海县	DQH
东壕	DOX
东湖	DMT
东花园	DNP
东佳木斯	DMB
董家坪	DPW
董家庄	DZK
东津	DKB
东京城	DJB
东来	RVD
东梁	DID
东陵	DRT
东门	DNB
洞庙河	DEP
东明村	DMD
东明县	DNF
东南营子	RND
东坡	DPF
氡泉	DOL
东山	DAL
东升	DRQ
东胜	DOC
东升坝	DAW
东胜西	DYC
东水峡	RSJ
东台	DBH
东田良	DTF
东通化	DTL
东土城	DTC
东湾	DRJ
东乡	DXG
东辛庄	DXD
东兴	DXC
东戌	RXP
东阳关	RGP
东营	DPK
东营子	DYD
东淤地	DBV
东榆林	DJV
东园	DYP
东元庆	DUF
东镇	DNV
东至	DCH
东庄	DZV
董庄	DFF
洞子村	DCJ
洞子崖	DFY
豆坝	DRW
窦店	DDP
豆各庄	RRP
斗沟子	DGB
斗虎屯	DOT
豆罗	DLV
豆沙关	DJW
豆张庄	RZP
豆庄	ROP
杜尔基	RRD
都格	DMM
杜家	DJL
杜家坎所	DTP
杜家台	DJC
都江堰	DDW
渡口	DXW
都拉营	DLW
独立屯	DTX
都伦	DLX
独山	RWW
渡市	RUW
读书铺	DPM
杜坞	DWS
都匀	RYW
杜赵	DEY
段家	DJD
段甲岭	RJP
对青山	DQB
兑镇	DWV
杜拉尔	DVX
敦化	DHL
敦煌	DHJ
墩义堂	RTH
多尔本毛道	DGC
峨嵋	EMA
峨边	EBW
峨眉	EMW
鄂州	ECN
额济纳	EJC
恩施	ESN
二岔	ECL
二道沟	RGC
二道沟门	RDP
二道河	RDL
二道桥	EKW
二道沙河	RDC
二道湾	RDX
二道岩	RDW
二宫	RGR
二井	EJA
二郎庙	EMF
二龙	RLD
二龙山	RIT
二龙山屯	ELA
二密河	RML
二堡	RBR
尔赛河	RSW
二塘	RTZ
二塘区	RTW
二营	RYJ
二营子	EYT
二连	RLC
发耳	FEM
范各庄	FGP
范家屯	FTT
繁峙	FSV
范镇	VZK
防城	FAZ
防城港	FEZ
防城港北	FBZ
房山	FRP
芳山镇	FSD
肥东	FIH
肥西	FAH
费县	FXK
汾河	FEV
分路口	FKH
分水寺	FRW
汾阳	FAV
分宜	FYG
封浜	FBA
丰城	FCG
丰城南	FNG
峰洞	FDW
丰都	FUW
峰峰	FFP
峰高铺	FPW
丰广	FGL
奉化	FHH
凤凰	FHZ
凤凰城	FHT
凤凰村	FHV
凤凰山	FHM
冯家坝	FBW
冯家山	FJY
枫泾	FJH
丰库	FKD
丰乐镇	FZB
丰林	FLT
风陵渡	FLV
丰南	FDP
封丘	FQF
丰润南	FPP
丰水村	FSJ
风水沟	FGD
丰顺	FUQ
丰台	FTP
丰台西	FXP
冯屯	FTX
凤县	FXY
凤翔	FOY
凤阳	FUH
枫叶岭	FYL
凤仪村	FIM
丰镇	FZC
凤州	FZY
佛岭	FLB
佛山	FSQ
佛峪	FYV
福安	FAS
附城	FCZ
富川	FDZ
福德	FOS
福鼎	FES
福港	FGG
府谷	FUV
富海	FHX
福海	FHR
傅家屯	FTD
富江镇	FJB
福金	FJT
富锦	FIB
福巨	FJC
符离集	FLH
福利屯	FTB
浮梁	FEG
富林	FLX
福临堡	FLY
涪陵	FLW
涪陵北	FEW
涪陵西	FFW
阜南	FNH
抚宁	FNP
阜宁	AKH
抚宁北	FBV
福清	FQS
福泉	VMW
福山口	FKP
福山寺	FSP
复盛	FAW
福生庄	FSC
抚顺	FST
抚顺北	FET
扶绥	FSZ
富太哈	FTL
浮图峪	FYP
福溪	FXW
富县	FEY
富县东	FDY
阜新	FXD
福兴地	FXC
阜阳	FYH
扶余	FYT
富裕	FYX
扶余北	FBT
富源	FYM
抚远	FYB
福州	FZS
抚州	FZG
抚州北	FBG
福州东	FDS
福州南	FYS
傅庄	FZP
富庄子	FIP
富拉尔基	FRX
嘎拉德斯汰	GLC
嘎什甸子	GXD
嘎什吐	GED
改貌	VHW
盖州	GXT
盖州西	GAT
干坝子	GZW
甘草店	GDJ
感德	GRS
干沟	GGL
甘谷	GGJ
甘河	GAX
甘河子	GZR
甘家坝	RAW
甘洛	VOW
甘泉	GQY
甘泉北	GEY
赶水	GSW
干塘	GNJ
甘棠	GTG
泔溪	VDW
干溪沟	KXW
赣县	GVG
赣州	GZG
赣州东	GDG
赣州南	GNG
刚察	GCO
缸窑	GOL
甘旗卡	GQD
高坝	GBA
高碑店	GBP
高碑店东	GMP
藁城	GEP
高村	GCV
高店铺	GPY
高尔山	GET
高峰	GFW
高各庄	GGP
高谷	FGW
高家	GJX
高家村	GAC
高家会	GHV
高家岁	GJT
高境庙	GJA
皋兰	GEJ
高老	GOB
高梁铺	GLY
高林屯	GOD
高岭	GLD
高楼房	GFM
高炉子	VZW
高密	GMK
高骈	VRW
高平	GPF
高坪铺	GPW
高桥镇	GZD
高泉	GQR
高山子	GSD
高寺台	VTP
高台	GTJ
高台山	GTD
高台子	GTX
高滩	GAY
高潭子	GTY
高头	GOX
高兴	VWW
高兴镇	GEG
高阳镇	GYT
高邑	GIP
高邑西	GNP
郜营	GYN
高州	GSQ
葛根庙	GGT
革居	GEM
格口	GKS
阁老坝	VPW
格勒	GKC
格里坪	VIW
隔蒲	GPN
格以头	GYM
革镇堡	GZT
革志	GVT
鸽子洞	GAD
根河	GEX
根龙	GOZ
艮山门	GSH
耿家屯	IAT
耿坡	GEF
格尔木	GRO
贡川	GCS
共和	GWW
公积坂	GJC
贡家台	GJP
公庙子	GMC
工农湖	GRT
共青城	GAG
功山	GSM
公兴	GUW
巩义	GXF
巩义南	GYF
公营子	GYD
公主埂	GZC
公主岭	GLT
公主岭南	GBT
沟帮子	GBD
沟口	GKX
构林	GOF
固安	GFP
古北口	GKP
古城	GCB
谷城	GCN
古城湾	GCC
古城镇	GZB
古城子	GFT
古店	GIV
孤店子	GZL
古东	GDV
古河	GHR
姑家堡	GPC
古家沱	GJW
孤家子	GKT
古交	GJV
谷口河	GKW
古浪	GLJ
古里金	GLX
古莲	GRX
古鲁满汗	GHC
孤山	GSC
孤山川	GSV
孤山口	GSP
孤山子	VSD
固始	GXN
古田	GTS
古冶	GYP
古营盘	GYC
菇园	GYL
古源	GUX
固原	GUJ
古砦	GRZ
古镇	GNQ
固镇	GEH
瓜房子	GFC
瓜州	GZJ
冠朝	GLG
关村坝	GMW
官渡	GDY
官高	GVP
观阁	VUW
官家	GUT
关林	GLF
关碾房	GNC
灌水	GST
官厅	GTP
官厅西	KEP
观音山	GYY
关寨	GRW
冠豸山	GSS
官字井	GOT
广安	VJW
广安门	GAP
广德	GRH
广德号	GDD
广汉	GHW
光辉	GHL
广梅汕铁旅	GMA
光明	GMX
光明城	IMQ
广南卫	GNM
广宁寺	GNT
广深铁旅	SAA
广盛	GND
广水	GSN
广顺场	GCW
广铁青旅	TQA
广通	GOM
广卫村	GWM
广兴	GXW
广元	GYW
广元东	GOW
广元南	GAW
光泽	GZS
广州	GZQ
广州北	GBQ
广州东	GGQ
广州南	IZQ
广州西	GXQ
归德乡	GEW
贵定	GTW
贵定南	IDW
贵港	GGZ
桂口	GUS
桂林	GLZ
桂林北	GBZ
桂平	GAZ
贵溪	GXG
贵阳	GIW
贵阳北	GBW
贵阳西	GQW
归流河	GHT
郭二庄	GRP
国光	GGR
果河	GBM
郭家店	GDT
郭家屯	GJD
郭磊庄	GLP
果松	GSL
涡阳	GYH
虢镇	GZY
郭尔奔敖包	GRC
哈川	HCX
哈达	HVX
哈达阳	HYX
哈尔盖	HRJ
哈福	HFL
哈拉	HLC
哈拉沟	HOX
哈拉海	HIT
哈拉黑	HET
哈拉苏	HAX
哈力图	HFX
蛤蟆塘	HMT
哈密	HMR
哈密东	HGR
哈密南	HLR
哈日努拉	HRD
哈业胡同	HTC
哈克	HKX
海安南	VMQ
海安县	HIH
海北	HEB
海城	HCT
海城西	HXT
海丰	HFD
海口	VUQ
海口东	HMQ
海浪	HAB
海林	HRB
海龙	HIL
海伦	HLB
海南票务	HNA
海宁	HNH
海宁西	EUH
海石湾	HSO
海棠寺	HTF
海坨子	HZT
海湾	RWH
海晏	HFO
海阳	HYK
海拉尔	HRX
海拉尔东	HLX
哈玛	HFT
韩城	HCY
汉川	HCN
寒葱沟	HKB
罕达盖	HWX
邯郸	HDP
邯郸东	HPP
韩府湾	HXJ
汉沟镇	HZP
汉沽	HGP
韩家村	HNC
韩家沟	HGD
韩家岭	HAV
韩家楼	HKV
韩家园	HJX
涵江	HJS
涵江北	HCS
韩坑	VKG
汉口	HKN
寒岭	HAT
韩麻营	HYP
汉寿	VSQ
汗苏鲁	HQC
罕台川	HCC
菡潭	HNG
韩堂	HDF
汉旺	HIW
汉王山	HOW
汉西	HXN
汉阳	HYN
汉阴	HQY
汉源	WHW
汉中	HOY
韩庄镇	HZF
杭锦后旗	HDC
杭锦旗	HJC
杭州	HZH
杭州北	HEH
杭州东	HGH
杭州东所	CVH
杭州南	XHH
好力套高	VGD
浩良河	HHB
好鲁库	HKC
豪门	HNX
哈尔巴岭	HRL
哈尔滨	HBB
哈尔滨东	VBB
哈尔滨西	VAB
哈尔滨南	VNB
赫尔洪得	HDX
鹤北	HMB
鹤壁	HAF
鹤壁北	HBF
鹤壁东	HFF
河边	HBV
合川	WKW
河唇	HCZ
和村	HNP
贺村	HCH
河东	HDJ
合肥	HFH
合肥北	HBH
合肥北城	COH
合肥西	HTH
鹤岗	HGB
和吉镇所	HBZ
禾家村	HJQ
贺家店	HJJ
何家湾	HJH
河间西	HXP
河津	HJV
和静	HJR
河口南	HKJ
鹤立	HOB
河里	HLZ
何刘	HIN
和龙	HLL
河洛营	HYD
河南	HEL
和平	VAQ
和平村	HIC
合浦	HVZ
和气庄	HVK
鹤庆	HQM
贺日斯台	HMC
何三家	HJD
鹤山	HSX
合山	HAZ
贺胜桥东	HLN
河市坝	HDW
和什托洛盖	VSR
河潭埠	HTG
河汤沟	HTD
核桃园	KHW
河湾	VAJ
河湾子	HUL
河下	HXG
合阳	HAY
河阳	IOW
荷叶	HQQ
荷叶花	HHD
河源	VIQ
菏泽	HIK
菏泽南	HOK
何寨	HRY
贺州	HIZ
黑城子	HCD
黑冲滩	HCJ
黑岗	HGX
黑河	HJB
黑河土	HAC
黑井	HIM
黑老湾	HWM
黑山	HED
黑山湖	HBJ
黑山寺	HVP
黑山头	HOL
黑石木	HST
黑石铺	HOQ
黑水	HOT
黑台	HQB
黑土凹	HTM
黑旺	HWK
横车	VEN
横道河子	HDB
恒地营	VVX
横店	HDN
横店东	HEN
横峰	HFG
横岗	HOG
横沟桥东	HNN
横江	RJW
横林	HHH
横岭关	HLV
衡山	HSQ
恒山	HSB
衡山西	HEQ
衡水	HSP
横水镇	HEV
横现河	HXY
衡阳	HYQ
衡阳北	HKQ
衡阳东	HVQ
横阳山	HRQ
呼和浩特	HHC
呼和浩特东	NDC
呼和温都尔	HPC
昆独仑召	KDC
红安	HWN
红安西	VXN
洪安乡	HAW
红白场	HVW
红层	HCR
洪洞	HDV
红房子	HZB
红峰	HFW
红峰岭	HFC
洪沟	HGK
红光	HUR
红光镇	IGW
红果	HEM
洪河	HPB
红花沟	VHD
红花铺	HHY
红花塘	HHW
红花园	HYW
洪家屯	HQP
洪家嘴	IHW
红江	HFM
红柳河	HHR
红茂	HMO
红旗	HQD
红旗村	HER
红旗坎	HKR
红旗营	HQX
宏庆	HEY
红砂坝	HSC
红砂岘	VSJ
红山	VSB
洪善	HSV
红山口	HSR
红石	HSD
红石砬子	HZL
红石崖	HSA
红寺堡	HSJ
红台	HTR
宏图	VTX
红土沟	HGM
红卫	VWJ
红卫坝	HWY
红岘台	HTJ
红星	VXB
鸿兴	HVT
红兴隆	VHB
红崖	HVV
红彦	VIX
洪掌	HUP
和田	VTR
后坝	HOC
厚坝	HBW
后封台	HFP
后沟	HOR
后官山	HVD
侯家坪	HJW
侯马	HMV
门	KMQ
后坪	HFQ
猴山	HEP
侯潭	HQH
厚溪	HIG
后溪街	HXH
后寨	HOF
后章村	HAP
侯杖子	HZD
侯宗庙	HJP
湖北	HBX
湖潮	HCW
湖东	HUV
虎尔虎拉	HHX
虎峰	HFB
湖丰	HUG
呼和浩特南	HWC
呼和西场	HCA
呼吉尔	HRC
忽吉图	HEC
胡家店	HDT
呼家塔	HTY
胡家营	HBN
湖口	HKG
呼兰	HUB
虎林	VLB
葫芦	HVC
葫芦岛	HLD
葫芦岛北	HPD
虎门	IUQ
湖南	HNT
琥珀湖	HPT
虎山	HVB
琥市	HSI
虎什哈	HHP
虎石台	HUT
湖田	HUK
湖头	HTS
呼图壁	HWR
湖屯	HRK
浒湾	EYN
户县	HUY
湖沿	HYG
呼源	VYX
呼中	VZX
湖州	VZH
湖州西	HVH
互助	HCB
互做布其	HZC
华安	HAS
华城	VCQ
化处	HEW
化德	HGC
花果	HGN
华家	HJT
华江	HUZ
花家庄	HJM
桦林	HIB
花龙门	HMM
花楼坝	HFY
桦南	HNB
花棚子	HZM
桦皮厂	HPL
花桥	VQH
画桥	HVG
华容	HRN
花山	HML
华山	HSY
华山北	HDY
化稍营	HXV
花吐古拉	HOD
花土坡	HMW
滑县南	HXF
华蓥	HUW
化鱼山	HYH
花园	HUN
华源	HWG
化州	HZZ
花庄	HZJ
淮安	AUH
淮安南	AMH
淮北	HRH
淮滨	HVN
怀化	HHQ
淮口	KYW
淮南	HAH
淮南东	HOH
淮南西	HPH
怀仁	HRV
怀柔	HRP
怀柔北	HBP
槐树下	HUQ
怀忠	HZG
桓龙湖	HKT
桓台	VTK
换新天	VTB
黄柏	HBL
黄草场	VQW
潢川	KCN
黄村	HCP
皇德	HEX
黄渡	HDH
黄渡所	02A
荒沟西	HGL
皇姑屯	HTT
黄瓜园	HYM
黄河南岸	HHF
黄河涯	HHK
黄花筒	HUD
黄集	UWH
黄家坝	HKW
黄家店	VDD
黄甲屯	HAD
黄家寨	HZY
黄口	KOH
黄老门	HMG
黄联关	HGW
黄梁梦	HMP
黄陵	ULY
黄流	UUQ
黄梅	VEH
黄梅山	HSH
黄泥河	HHL
黄泥崴子	HQL
黄平	VFW
黄n	HQW
黄沙河	HHZ
荒山	HSL
黄山	HKH
黄石	HSN
黄石东	OSN
黄水塘	HSW
黄丝	HRW
黄松甸	HDL
黄桶	HWW
黄土岗	HGG
黄土坡	HTP
黄许镇	HXW
黄洋	VVW
黄羊城	HIV
黄阳司	HAQ
黄羊滩	HGJ
黄羊湾	HWJ
黄羊镇	HYJ
湟源	HNO
黄州	VON
库都尔	KDX
惠东	KDQ
回郭镇	HNF
辉河	HIX
汇流河	HUX
回龙庵	HNM
回龙坝	HZW
辉南	HNL
汇南	IKW
惠农	HMJ
辉森乌拉西	HXC
惠山	VCH
汇塘河	HNW
灰腾梁	HUC
会同	VTQ
徽县	HYY
惠州	HCQ
惠州南	KNQ
惠州西	VXQ
呼鲁斯太	VTJ
浑河	HHT
浑江西	HXL
霍尔果斯	HFR
获嘉	HJF
火炬沟	HKL
火连寨	HLT
霍林郭勒	HWD
霍林河	HND
火龙岗	HLH
获鹿	HLP
获鹿所	KLP
霍邱	FBH
火烧寨	HVY
火石泉	HQR
火焰山	HYR
霍州	HZV
加格达奇	JGX
扎赉诺尔	ZRX
扎赉诺尔西	ZXX
吉安	VAG
集安	JAL
吉安南	VNG
基长	JAM
鸡场坡	JRW
继承	JCX
鸡东	JOB
芨东	JDR
鸡冠山	JST
济华夏	JHO
纪家	JJL
纪家沟	VJD
鸡街	JJM
积金	JLW
吉兰泰	JTC
吉林	JLL
吉林西	JXL
芨岭	JLJ
即墨	JMK
济南	JNK
济南东	JAK
济南南	JRK
济南西	JGK
济南中心	JAA
集宁	JNC
济宁	JIK
集宁南	JAC
稷山	JVV
吉山	JSQ
吉首	JIQ
吉首南	JAQ
吉舒	JSL
吉水	VUG
基太	JTI
济铁建行	JBA
济铁旅	JLO
吉文	JWX
鸡西	JXB
绩溪县	JRH
蓟县	JKP
蓟县南	JIP
蓟县西	JIV
吉新河	JXX
济源	JYF
贾庵子	JQP
嘉川	JQW
嘉峰	JFF
夹河寨	IZH
贾家街	JYT
加劳	JAW
佳木斯	JMB
加南	JAX
嘉善	JSH
甲山	JOP
嘉善南	EAH
嘉祥	JUK
夹心子	JXT
嘉兴	JXH
嘉兴南	EPH
嘉峪关	JGJ
建北	JUD
建昌	JFD
涧池铺	JCY
碱柜	JGC
建湖	AJH
健民	JMT
建宁县北	JCS
建瓯	JVS
笕桥	JIH
建三江	JIB
建设	JET
建始	JRN
建水	JSM
建水北	JBM
简阳	JYW
建阳	JYS
江北	JIL
江边村	JBG
蒋村	JCV
江都	UDH
江海	JNQ
江华	JHZ
江家	JAG
姜家	JJB
江家岭	JJD
江津	JJW
将军河	JHN
将军堡	JAT
将乐	JLS
江门	JWQ
江密峰	TFL
江宁	JJH
江桥	JQX
江桥镇	JCH
江山	JUH
江所田	JOM
江西村	JAZ
姜堰	UEH
江永	JYZ
江油	JFW
江源	SZL
绛帐	JZY
交城	JNV
蛟河	JHL
角美	JES
蕉溪	JXW
胶州	JXK
胶州北	JZK
焦作	JOF
焦作东	WEF
街洞	JDQ
街基	JJT
界牌	JPV
界山	JSB
界首	JSK
界首市	JHH
介休	JXV
揭阳	JRQ
金宝屯	JBD
金昌	JCJ
浸长村	QCM
金场堡	JPD
金城	JCD
晋城	JCF
晋城北	JEF
金城江	JJZ
金刚沱	JGW
金沟	JGD
金沟屯	VGP
金谷	JGS
金河	JHX
锦和	JHQ
锦河	JHB
津沪所	00A
金华南	RNH
金华西	JBH
金鸡村	JCZ
金家店	JJC
晋江	JJS
锦界	JEY
金坑	JKT
金口河	JHW
金林	JNX
金岭镇	JLK
金马村	JMM
金沙滩	JTV
金沙湾	JWW
金山	JND
金山北	EGH
金山桥	JRS
金山屯	JTB
金山湾	JWT
金山卫	BGH
金山卫东	JDH
金山卫西	JEH
金山园区	REH
劲松	JOX
金堂	JDW
进贤	JUG
金银川	JCR
金银沟	JOT
缙云	JYH
金寨	JZH
金杖子	JYD
金钟	JBW
金州	JZT
锦州	JZD
晋州	JXP
锦州南	JOD
金珠	JVL
靖边	JIY
景德镇	JCG
景德镇南	JNG
井店	JFP
井冈山	JGG
静海	JHP
精河	JHR
精河南	JIR
经久	JNW
井口	JKW
京联合	99P
静岭	JLX
荆门	JMN
井南	JNP
经棚	JPC
京山	JCN
景泰	JTJ
镜铁山	JVJ
井头墟	JXZ
荆西	JXS
井陉	JJP
景阳屯	JTT
靖远	JYJ
靖远西	JXJ
靖州	JEQ
荆州	JBN
敬梓场	JCW
久长	JUW
九道岭	JDD
鹫峰	JBP
九公里	JUB
九江	JJG
九江西	JKG
九里	JEW
九里垄	VLG
九里山	JSF
九龙	JQO
九龙山	JSP
九龙塘	JTW
酒泉	JQJ
九三	SSX
九台	JTL
九台南	JNL
九王庄	JZP
九燕山	JUY
九营	JYB
韭园	JPP
九站	JZL
旧站	JNT
旧庄窝	JVP
巨宝	JRT
巨各庄	JGP
聚乐堡	JLV
巨流河	JHD
莒南	JOK
句容西	JWH
巨亭	JTY
莒县	JKK
巨野	JYK
居庸关	JYP
聚源	IIW
鄄城	JCK
峻德	JDB
军户	JVR
军粮城	JLP
军粮城北	JMP
军山	VSG
朱日和	ZRC
喀喇其	KQX
喀拉玉尔滚	KYR
卡路屯	KLB
卡伦	KLL
喀什	KSR
开安	KAT
凯北	KBB
开道	KDB
开封	KFF
开干齐	KQR
开江	KAW
凯里	KLW
开鲁	KLC
开平	KPP
开通	KTT
开原	KYT
开原西	KXT
康城	KCP
康金井	KJB
康熙岭	KXZ
康庄	KZP
靠山屯	KTL
克拉玛依	KHR
克东	KOB
柯柯	KKO
岢岚	KLV
克利	KLX
柯坪	KPR
克山	KSB
柯坦	KTH
克一河	KHX
孔家	KJD
孔家沟	IJD
孔家庄	KJP
孔垄	KLG
孔滩	KTW
孔庄	KZF
库尔勒	KLR
口前	KQL
口泉	KQV
口头	KTK
库车	KCR
库伦	KLD
宽甸	KDT
宽沟	KGB
矿山村	KSP
魁岐	KQS
奎山	KAB
葵潭	KTQ
奎屯	KTR
奎屯东	KDR
奎屯西	KRR
昆都庙	KDD
昆明	KMM
昆明北	KBM
昆明东	KDM
昆明西	KXM
昆山	KSH
昆山南	KNH
昆阳	KAM
拉白	UBW
拉法	LFL
拉古	LGB
拉哈	LHX
拉拉屯	LWD
拉林	LAB
喇嘛甸	LMX
喇嘛山	LSX
拉萨	LSO
拉	LEM
砬子河	LVL
来宾	UBZ
来宾北	UCZ
来福	UFT
濑湍	LVZ
莱芜东	LWK
莱芜西	UXK
莱西	LXK
莱阳	LYK
涞源	LYP
来舟	LZS
滥坝	LQW
蓝村	LCK
栏杆滩	LGW
兰岗	LNB
兰家	LJD
蓝家村	LCZ
兰家屯	LAT
兰考	LKF
兰棱	LLB
兰岭	ULB
兰滩	LAY
兰溪	LWH
兰州	LZJ
兰州东	LVJ
兰州金轮	LZO
兰州西	LAJ
廊坊	LJP
廊坊北	LFP
浪河	LHN
狼山	LEP
狼尾山	LRJ
狼窝铺	UOP
朗乡	LXB
琅琊	UNW
老边	LLT
捞刀河	LHQ
劳动屯	LMT
老府	UFD
老古沟	LOT
老锅厂	KGW
老哈河	LAD
老河口东	LDN
老莱	LAX
老岭	LRL
老庙	LML
老堡	UPZ
醪桥	UQG
老松岭	LKL
老头沟	LGL
老王洞	UEW
老羊壕	LYC
老爷岭	LLL
老伊尔施	IIT
老营	LXL
乐坝	VBW
乐昌	LCQ
乐昌东	LOQ
乐都	LDO
乐化	LHG
乐平市	LPG
乐山	UTW
乐善村	LUM
乐素河	LSY
乐土驿	LTR
乐武	UWW
乐园	UYL
乐跃	UYW
雷锋路	LIT
磊口	LVF
耒阳	LYQ
耒阳西	LPQ
雷州	UAQ
雷庄	LZP
冷水	LOY
冷水江东	UDQ
里八庄	LAV
李冰广场	LEW
黎城	UCP
利川	LCN
离堆公园	INW
李浩寨	LMM
李河	RHW
李家	LJB
励家	LID
李家店	LFT
李家沟	LOD
李家河	LJY
李家坪	LIJ
理家坪	UZZ
李家屯	LJT
李家湾	LYW
丽江	LHM
丽江东	LIM
李金	LND
里腊	LAM
醴陵	LLG
栗木	LMN
里木店	LMB
李七庄	UQP
厉山	LSN
李石寨	LET
李市镇	LZW
梨树湾	USW
梨树镇	LSB
丽水	USH
溧水	LDH
利水	LSS
黎塘	LTZ
黎塘西	UKZ
李屯	LVD
李　屯	LEF
李旺	VLJ
澧县	LEQ
溧阳	LEH
礼乐	UEQ
李珍	LZF
立志	LZX
礼州	UZW
李子沟	URW
莲东	LGF
莲河	LAL
联合乡	UXW
莲花山	LHD
连江	LKS
廉江	LJZ
连江口	LJQ
莲江口	LHB
连山关	LGT
莲塘	LTG
涟源	LAQ
连云港	UIH
连云港东	UKH
连珠山	LIB
亮兵台	LBL
良村	LNP
两当	LDY
梁底下	LDP
凉风垭	LRW
良各庄	LGP
两河口	LKW
凉红	UIW
两家	UJT
梁家坝	LBY
亮甲店	LRT
梁家渡	LDG
两路口	ULW
梁平	UQW
梁山	LMK
凉水井	FSW
两所屯	UAW
凉亭河	LHH
凉雾	LOW
良乡	LAP
聊城	UCK
聊城北	UBK
聊城东	UDK
了墩	LDR
辽阳	LYT
辽源	LYL
辽中	LZD
临巴溪	UVW
林场	LIH
临川	LCG
林村	LCP
林东	LRC
临汾	LFV
林海	LXX
临海	UFH
临河	LHC
蔺家楼	ULK
林家台	LQT
临江	LQL
临江场	LNW
临江寺	LSW
林口	LKB
临澧	LWQ
临平	LPH
临清	UQK
临汝镇	LWF
林盛堡	LBT
蔺市	LWW
临水	LIP
临潼	LIY
临潼东	LQY
林西	LXC
临西	UEP
林县	LSF
临湘	LXQ
临沂	LVK
临沂北	UYK
临沂南	UNK
临颍	LNF
林源	LYX
临泽	LEJ
临淄	LZK
林子头	LIL
灵宝	LBF
灵宝西	LPF
岭北	LBX
灵璧	GMH
灵川	LUZ
凌村所	UMZ
凌海	JID
凌家场	LAW
临江溪	LVW
灵杰	UJW
零口	LKY
陵口	LKH
伶俐	LLZ
零陵	UWZ
岭南	LWX
灵丘	LVV
陵丘	LQX
灵山	LNT
灵石	LSV
陵水	LIQ
岭头	LOS
灵武	LNJ
灵仙庙	LXW
凌源	LYD
凌源东	LDD
六安	UAH
柳城	UHZ
柳村北	LBP
六道河	LEL
六道河子	LVP
六地沟	LGC
流芳	LFN
六个鸡	UOW
刘沟	LDW
柳沟	LUJ
柳河	LNL
六合	KLH
六合镇	LEX
刘集	LKI
六家	LZL
刘家村	AJT
刘家店	UDT
刘家沟	LNY
刘家河	LVT
柳家庄	LJJ
琉璃河	LLP
六里坪	LLN
柳林河	LLV
柳林南	LKV
柳毛	LEB
柳毛沟	UML
六盘山	UPJ
六盘水	UMW
六盘水南	KPW
留守营	LQP
柳树	LOB
柳树河	LHL
柳树泉	LSR
柳树屯	LSD
流水沟	USP
柳铁海口	LHA
刘屯	LKD
刘伟壕	LWC
流溪场	HUH
柳辛庄	LUP
柳园	DHR
刘征	UZK
六枝	LIW
柳州	LZZ
柳州北	LBZ
柳州南	LNZ
柳州直销	99Z
留庄	UZF
隆安	UVZ
龙伯屯	LOZ
隆昌	LCW
龙池	UPW
龙川	LUQ
龙船	LCB
龙凤	LFX
龙沟	LGJ
龙骨甸	LGM
龙广	UGZ
龙华	LHP
隆化	UHP
龙嘉	UJL
龙家堡	LPL
龙家营	LKP
龙家营所	UFP
龙江	LJX
龙井	LJL
龙口	UKG
龙里	LLW
龙门河	MHA
龙门镇	LSQ
龙南	UNG
龙泉	LWL
龙泉寺	UQJ
龙山	LSL
龙山镇	LAS
隆盛	NSW
龙水坪	LCL
龙潭山	LTL
龙潭寺	LTW
龙塘坝	LBM
龙头	LDT
陇西	LXJ
陇县	LXY
龙岩	LYS
隆尧县	LWP
龙游	LMH
龙镇	LZA
龙爪沟	LZT
娄底	LDQ
娄山关	UKW
胪滨	LNX
芦潮港	UCH
潞城	UTP
潞城乡	UXZ
陆川	LKZ
鹿道	LDL
鲁番	LVM
禄丰	LFM
陆丰	LLQ
芦沟	LOM
鲁河	LUX
芦洪市	UMQ
芦家村	LJC
芦家庄	LJV
路家庄	LUV
庐江	UJH
路口铺	LKQ
陆良	LRM
卢龙	UAP
卢龙北	LOV
炉桥	LQH
庐山	LSG
鲁山	LAF
禄市	UUW
露水河	LUL
芦台	LTP
芦溪	LUG
泸阳	UYQ
鹿寨	LIZ
鹿寨北	LSZ
芦庄	LZV
滦河	UDP
滦河沿	UNP
滦平	UPP
乱石山	LCT
滦县	UXP
滦县东	LXP
略阳	LYY
轮台	LAR
洛川东	LRY
洛东	LYZ
落垡	LOP
罗坊	LFG
倮果	VGW
漯河	LON
漯河西	LBN
珞璜	LHW
罗家	LUD
罗家屯	LTV
罗江	LJW
洛满	LMZ
洛门	LMJ
罗陂岗	LNG
罗平	LPM
落坡岭	LPP
罗山	LRN
螺山	LSP
罗田	LPW
骆驼岭	LLD
骆驼山	LOL
骆驼巷	LTJ
罗文	LWY
罗文皂	LWV
洛阳	LYF
洛阳北	LIF
洛阳东	LDF
洛阳龙门	LLF
罗源	LVS
吕坊	LIG
吕河	LUY
绿化	LWJ
吕梁	LHV
旅顺	LST
旅顺西	UUK
绿潭	LTB
马鞍岭	MAL
马鞍山	MAH
马坝	MBQ
马场	MCW
麻城	MCN
麻城北	MBN
马村	MRW
马房	MNM
马嘎	MVW
马盖图	MGC
麻虎	MHY
马皇	MHZ
马回岭	MHG
马家堡	MJP
马架子	MBC
麻江	BBW
马角坝	MBW
马街	MJW
马坑	MES
麻栗	MLW
马莲河	MHB
马林	MID
麻柳	MLY
马柳	MLP
麻柳镇	RRW
马龙	MGM
马路圩	MUZ
玛纳斯湖	MHR
马棚	MVN
马铺营	MPP
马桥河	MQB
马三家	MJT
麻山	MAB
马蹄湾	MTY
马田墟	MXQ
马头	MTP
麻旺	NOW
麻尾	VAW
马尾	MWS
马尾山	MWL
马相屯	MXL
麻阳	MVQ
麻芝铺	MPW
麦园	MYS
满村	MEF
满归	MHX
满汉营	MYD
漫流河	MIP
漫水湾	MKW
满洲里	MLX
玛纳斯	MSR
毛坝	MBY
毛坝关	MGY
茅草坪	KPM
毛德呼热	MFC
帽儿山	MRB
毛告吐	MOD
茂林	MLD
茅岭	MLZ
茂名	MMZ
茂名东	MDQ
茂舍祖	MOM
么荒	YWD
么铺	YEW
美岱召	MDC
梅河口	MHL
梅花山	MHW
梅江	MKQ
美兰	MHQ
梅陇	MLE
眉山	MSW
梅水坑	MSS
煤田	MTX
美溪	MEB
煤窑沟	MYR
梅州	MOQ
梅子铺	MPY
门达	MDD
门头沟	MGP
猛洞河	MUQ
蒙渡	MUW
孟家岗	MGB
孟津	MJF
猛鹫山	MOT
孟庙	MMN
蒙自北	MBM
密地	MXW
弥渡	MDF
汨罗	MLQ
汨罗东	MQQ
密马龙	MMM
米沙子	MST
密山	MSB
密山西	MXB
密县	MXF
米易	MMW
密云	MUP
米脂	MEY
渑池	MCF
渑池南	MFF
免渡河	MDX
冕宁	UGW
冕山	MQW
勉西	MOY
勉县	MVY
绵阳	MYW
绵竹	MIW
庙坝	MGW
庙城	MAP
庙宫	MGD
庙梁	MIC
庙岭	MLL
庙山	MSN
庙台子	MZB
庙头	MTZ
庙下	MBF
庙阳	MYT
庙庄	MZJ
庙子沟	MZW
乜吐硕	MTD
民福寺	MFW
民家	MGT
闵家屯	MTT
闽清	MQS
民权	MQF
民生村	MVP
民族	MZC
明安	MAC
明城	MCL
明港	MGN
明港东	MDN
明光	MGH
鸣李	MLV
明水河	MUT
明阳	MET
明珠	MFQ
墨池坝	MOW
墨冲	VCW
磨刀石	MOB
莫尔格	MEC
蘑菇滩	MTR
漠河	MVX
莫莫营子	MMD
磨盘山	MPL
磨滩	MTF
磨溪	JIW
磨心坡	VNW
墨玉	MUR
莫尔道嘎	MRX
沐埠岭	MLK
木城涧	MHP
牧城子	MBT
牡丹江	MDB
木瓜坪	MWW
木戛	MAW
穆家店	MIT
穆棱	MLB
木里图	MUD
木林	MNV
沐滂	MPQ
牧羊村	MCM
牧原	MYX
木竹河	MEW
那花所	NGZ
纳林沟门	NMC
那林桃亥	NLC
那罗	ULZ
那铺	NPZ
那曲	NQO
那玉	NYW
乃林	NLD
奈曼	NMD
奶姆庄	NMM
奈字井	NID
南安	NAS
南岸坝	NAW
南白镇	NBW
南博山	NBK
南仓	NCP
南岔	NCB
南昌	NCG
南昌北	NBG
南昌西	NXG
南陈铺	NCF
南城	NDG
南城司	NSP
南充	NCW
南充东	NTW
南充西	KIW
南仇	NCK
南川	KWW
南大庙	NMP
南大寺	NDP
南丹	NDZ
南定	NDK
南尔岗	NVW
南芬	NFT
南丰	NFG
南岗	NGQ
南宫东	NFP
南宫山	NGW
南沟	NGL
南观村	NGP
南关岭	NLT
南河	NHV
南河川	NHJ
南湖东	NDN
南华	NHS
南季家疃	NJK
南j	NJP
南京	NJH
南靖	NJS
南京北	VBH
南京东	NDH
南京南	NKH
南京西	NIH
南康	NAG
南口	NKP
南口前	NKT
南朗	NNQ
南岭	NAD
南木	NMX
楠木塘	NTQ
南宁	NNZ
南宁东	NFZ
南宁南	NUZ
南票	NPD
南平	NPS
南平南	NNS
南堡	NPP
南桥	NQD
南社	NSQ
南台	NTT
南汤	NGD
南塘镇	NTG
南洮南	NOT
南通	NUH
南头	NOQ
南洼	NWD
南湾子	NWP
南溪沟	NXY
南翔	NXH
南翔北	NEH
南翔北所	03A
南新城	NAP
南兴安	NIT
南星桥	NQH
南阳	NFF
南阳东	NDF
南阳西	NVF
南阳寨	NYF
南营井	NEP
南峪	NUP
南园村	NYC
南杂木	NZT
南张村	NZP
南召	NAF
闹海营	NHP
讷尔克气	NKX
讷河	NHX
内江	NJW
内江东	NDW
内江南	NXW
内乡	NXF
嫩江	NGX
能家	NJD
尼波	NPW
泥河子	NHD
尼勒克	NIR
尼日	NRW
鲇鱼山	NYG
碾子山	NZX
娘娘庙	NNY
娘子关	NIP
聂各庄	NBP
聂河	NIX
捏掌	NZF
宁安	NAB
宁波	NGH
宁波东	NVH
宁村	NCZ
宁德	NES
宁国	NNH
宁海	NHH
宁家	NVT
宁陵县	NLF
宁明	NMZ
宁武	NWV
宁武西	NWA
宁乡	NXQ
牛耳河	NRX
牛汾台	NRT
牛家	NJB
牛家梁	NLY
牛家营子	NYD
牛角山	NJT
牛街	NIM
牛街庄	NJM
牛晶坪	NJV
牛栏山	NLP
牛坪子	NZW
牛驼	NTA
牛心台	NXT
牛庄	NZD
农安	NAT
农垦四团	NKC
农乐	ILW
弄弄坪	NNW
暖泉	NQJ
女儿河	NRD
乌奴耳	WRX
敖力布告	ALD
鄂尔多斯	EEC
乌尔旗汗	WHX
欧里	OLD
徘徊北	PHP
磐安镇	PAJ
盘古	PGX
盘古寺	PGF
盘关	PAM
潘家	PJD
潘家店	PDP
盘脚营	PJW
盘锦	PVD
盘锦北	PBD
蟠龙镇	PLY
磐石	PSL
攀枝花	PRW
跑马山	PMM
泡子	POD
裴德	PDB
裴沟	PVF
沛屯	PUA
沛县	PXI
蓬安	PAW
彭城	PCP
蓬莱	PLW
彭山	PSW
彭水	PHW
蓬溪	KZW
彭阳	PYJ
彭泽	PZG
彭州	PMW
彭州南	PKW
劈柴沟	PGN
皮口	PKT
皮山	PSR
郫县	PWW
郫县东	PFW
郫县西	PCW
邳州	PJH
偏店	PRP
偏岭	PNT
瓢儿屯	PRT
品甸	PDZ
平安	PAL
平安城	PAV
平安堡	PAD
平安驿	PNO
平安镇	PZT
平坝	PBW
平川	PCL
平等	PDW
平顶庙	PDC
平顶山	PEN
平顶山西	BFF
平东	PDL
平坊	PVP
平房	PFB
平岗	PGL
平谷	PUV
平关	PGM
平果	PGZ
苹果园	PGP
平河口	PHM
平湖	PHQ
平湖南	PNQ
平吉堡	PJJ
平凉	PIJ
平凉南	POJ
苹林	PLS
平林村	PCZ
平罗	SZJ
平南	PAZ
平泉	PQP
平山	PSB
平社	PSV
坪石	PSQ
平台	PVT
平田	PTM
平旺	PWV
凭祥	PXZ
萍乡	PXG
凭祥北	PBZ
平型关	PGV
平洋	PYX
平遥	PYV
平邑	PIK
平义分	PEP
平峪	PYP
平原	PYK
平原堡	PPJ
平庄	PZD
平庄南	PND
坡底村	PDY
坡底下	PXJ
普安	PAN
蒲坝	PVW
蒲城	PCY
蒲城东	PEY
普定	PGW
普洱渡	PUW
铺集	PJK
普济	PIW
蒲家	PUY
浦江	PVH
普兰店	PLT
普宁	PEQ
蒲圻	PQN
蒲山店	PSF
葡萄菁	PTW
莆田	PTS
圃田西	ZDF
普湾	PWT
普雄	POW
蒲阳	DQW
嵯岗	CAX
查干诺尔	CGC
查干特格	CTC
察素齐	CSC
七宝	QPH
蕲春	QRN
七道河	QDL
七道桥	QUP
七甸	QDM
祁东	QWQ
祁东北	QRQ
奇峰塔	QVP
旗杆底	QGT
齐哈日格图	QHC
祁家堡	QBT
七家子	QCT
七间房	QJL
七里河	QLD
七里坪	QPY
七龙星	QLW
祁门	QIH
棋盘	QPL
齐齐哈尔	QHX
七泉湖	QHR
旗山	QSX
岐山	QAY
戚墅堰	QYH
七苏木	QSC
七台河	QTB
旗下营	QXC
旗下营东	QDC
祁县	QXV
淇县	QXF
七眼桥	QQW
祁阳	QMQ
祁阳北	QVQ
七营	QYJ
齐岳山	QMW
迁安	QQP
乾安	QOT
迁安北	QBV
前场	QCS
千岛湖	QHH
前甸	QDT
前锋	QFB
千河	QUY
前河	QHL
钱家店	QJD
黔江	QNW
潜江	QJN
前进镇	QEB
前磨头	QMP
前山	QXQ
前十家	QVD
钱塘江	QTH
前卫	QWD
前苇塘	QWP
迁西	QIV
千阳	QOY
前窑	QVL
前榆	QUD
前寨	QAV
墙子路	QZP
桥北	QQT
乔村	QAA
桥南	QNK
乔司	QAH
桥头	QAT
桥头村	QTM
桥湾	QVJ
桥西	QXJ
茄子溪	QXW
勤丰营	QFM
沁河北	QBF
秦皇岛	QTP
秦皇岛东	QDV
秦家	QJB
秦家庄	QZV
綦江	QJW
綦江北	QOW
秦岭	QLY
沁县	QVV
沁阳	QYF
钦州	QRZ
钦州北	QBZ
钦州东	QDZ
庆安	QAB
青白江	QBW
青城山	QSW
青岛	QDK
青岛北	QHK
青堆子	QDD
庆丰	QFT
清风店	QFP
青杠	QGW
青沟子	QOL
清河	QIP
清河城	QYP
清河门	QHD
清河桥	QOD
青花	QIY
庆华	QHW
清华园	QHP
清涧	QJV
清涧县	QNY
清凉店	QDP
青岭子	QZB
青龙	QIB
青龙场	QUW
青龙桥	QLP
青龙山	QGH
青龙寺	QSM
清平	QAW
青山	QSB
庆盛	QSQ
青石崖	QSY
清水	QUJ
清水沟	WNW
清水河	QHT
清水河西	QHZ
清水涧	QSP
青水山	VSX
青田	QVH
青铜峡	QTJ
青溪	QIW
青县	QXP
清徐	QUV
庆阳山	QSJ
青羊湾	QYA
清原	QYT
清远	QBQ
青州	QZS
青州市	QZK
成吉思汗	CJX
琼海	QYQ
秋梨沟	QGL
秋木园	QYM
秋木庄	QMT
取柴河	QCL
曲阜	QFK
曲阜东	QAK
曲家店	QND
曲江	QIM
曲靖	QJM
渠旧	QJZ
渠黎	QLZ
曲水	QSL
渠县	QRW
衢州	QEH
权村	QCP
泉沟	QGD
权河	QEY
泉江	QJG
全椒	INH
全胜	QVB
泉水	QST
泉水屯	IUT
泉阳	QYL
泉州	QYS
全州	QZZ
泉州东	QRS
全州南	QNZ
确山	QSN
楚鲁图	CLC
群力	QIX
冉家河	RJY
穰东	RDF
河	REF
饶平	RVQ
饶阳	RVP
绕阳河	RHD
热水	RSD
任家店	RJD
任家湾	BNY
任丘	RQP
日新	RXD
日照	RZK
融安	RAZ
荣昌	RCW
容桂	RUQ
融水	RSZ
容县	RXZ
如东	RIH
如皋	RBH
汝箕沟	RQJ
乳山	ROK
汝阳	RYF
汝州	ROF
瑞安	RAH
瑞昌	RCG
瑞金	RJG
萨拉齐	SLC
萨拉齐东	SCC
赛金桥	OJW
赛鱼	ORP
赛汗塔拉	SHC
赛乌苏	SWC
三把火	SBD
三百吨	SUP
三宝屯	SVT
三卜素	SUC
三岔镇	OCV
三道沟	SGL
三道桥	SDX
三道堰	DVW
三道营	SDC
三队	SAL
三堆子	ODW
三葛庄	SGR
三给村	SGV
三关口	OKJ
三合场	SEW
三河县	OXP
三合庄	SVP
三花石	SUY
三汇坝	OUW
三汇镇	OZW
三家店	ODP
三家寨	SMM
三家子	OID
三间房	SFX
三江	SNW
三江口	SKD
三江县	SOZ
三江镇	SJG
三介海子	SPC
三林	SOD
三茂铁旅	SMA
三门峡	SMF
三门峡南	SCF
三门峡西	SXF
三门县	OQH
三明	SMS
三明北	SHS
三明东	SDS
三平	OWP
三坪	SPR
三堡	SPP
三十家	SRD
三十里堡	SST
三十里铺	LAH
三十三号	SRT
三水	SJQ
三台	STD
三唐	STK
三堂集	SDH
三星	OXW
三亚	SEQ
三阳川	SYJ
三义井	OYD
三营	OEJ
三营图	QIC
三原	SAY
三元坝	OYW
三源浦	SYL
桑根达来	OGC
桑园子	SAJ
色树坟	SFP
沙坝	OIW
沙坝子	SQC
沙厂坪	SPZ
莎车	SCR
沙城	SCP
沙村	SCG
沙海	SED
沙河	SHP
沙河口	SKT
沙河市	VOP
沙后所	SSD
沙琅	OUQ
沙力	SIX
沙良	SIC
沙岭子	SLP
沙马拉达	OLW
沙坪坝	CYW
沙坡头	SFJ
沙浦	SHQ
沙日乃	ORC
沙沙圪台	SYC
沙沙坡	OGW
沙塘	IEH
沙沱	SFM
沙坨子	SMD
沙湾	SVW
沙湾县	SXR
沙溪坝	SBW
沙县	SAS
沙园	OAB
沙子河	OPP
山场屯	SCD
山城镇	SCL
山丹	SDJ
山海关	SHD
山河屯	SHL
山口	SKR
山岭子	OGP
山坡东	SBN
鄯善	SSR
山市	SQB
杉松岗	SBL
汕头	OTQ
山湾子	OWD
汕尾	OGQ
山阳	SPH
上安	SAP
上板城	SBP
上板城南	OBP
上仓	SKP
商城	SWN
上店	ODC
商都	SXC
上高镇	SVK
上格达	SDM
上谷	SGP
上关	SGM
上海	SHH
上海虹桥	AOH
上海南	SNH
上海西	SXH
上杭	JBS
上湖	SRV
尚家	SJB
上街	SJF
商酒务	SWF
上兰村	SLV
商洛	OLY
商南	ONY
上普雄	OPW
商丘	SQF
商丘北	SBF
商丘南	SPF
上泉	OAP
上饶	SRG
上水头	OUP
上万	SWP
尚武	SWW
上西铺	SXM
上腰墩	SPJ
上营	SNL
上虞	BDH
上虞北	SSH
上园	SUD
尚志	SZB
尚庄	SRF
邵东	SOQ
韶关	SNQ
韶关东	SGQ
邵家堂	SJJ
韶山	SSQ
绍水	SSZ
邵武	SWS
绍兴	SOH
绍兴北	SLH
邵阳	SYQ
舍伯吐	OBD
畲江	OCQ
滠口	SKN
舍力	SOT
舍力虎	VLD
涉县	OEP
歙县	OVH
神池	SMV
神池南	ONV
申德	ODD
神东	SOC
绅坊	OLH
沈家	OJB
申家店	ODB
沈家河	OJJ
深井子	SWT
神木	OMY
神木北	OMV
神木西	OUY
沈丘	SQN
神树	SWB
神头	SEV
沈阳	SYT
沈阳北	SBT
沈阳东	SDT
沈阳西	OXT
神峪河	SRY
深圳	SZQ
深圳北	IOQ
深圳东	BJQ
深圳坪山	IFQ
深圳西	OSQ
深州	OZP
升昌	OEB
圣浪	OVB
胜利	SIT
胜利桥	SLR
生芝渠	RZY
石坝	OBJ
十八台	SBC
十八站	SBX
石板墩	SDR
石板哨	SRW
石板滩	SAW
施秉	AQW
世博园	ZWT
石长	OCB
石场	SKW
石城	SCT
十渡	SEP
十二里阁	SRK
什邡	OFW
石圪台	STC
石河子	SZR
石湖	SPL
柿花树	SKM
石灰窑	OOD
石家	OJL
石家砭	SFY
史家铺	SPY
石家庄	SJP
石家庄北	VVP
十家子	SJD
施家嘴	SHM
石涧	STF
十间房	OFD
石景山	SNP
石景山南	SRP
石郎庄	OLP
什里店	OMP
十里坪	SKL
石林	SLM
石磷	SPB
石林南	LNM
石岭	SOL
石龙	SLQ
石楼	SZP
石马坝	SDW
石门	SMP
石门村	SMC
石门坎	SMW
石门岭	SLT
石门县	OMQ
石门县北	VFQ
石门子	SZX
石庙沟	SGY
石脑	SVD
石牌	SPQ
石桥镇	SZW
石桥子	SQT
石泉县	SXY
石人	SRL
石人城	SRB
石人沟	OHP
十三间房	SFR
石山	SAD
石塘路	STP
石头	OTB
石头河	SVL
石沱	OWW
石峡子	SXJ
石岘	SXL
石丫口	SOW
十堰	SNN
石燕桥	SQW
石柱槽	SCY
石柱县	OSW
师庄	SNM
石子坝	SXW
狮子山	OZH
石子山	HLW
狮子营	SZF
师宗	SEM
石嘴山	QQJ
首山	SAT
寿阳	SYV
舒城	OCH
蜀河	SHY
舒兰	SLL
疏勒	SUR
疏勒河	SHJ
树林	SLX
沭阳	FMH
署字井	OJT
双安屯	STL
双城北	SBB
双城堡	SCB
双丰	OFB
双峰寺	OFP
双凤驿	SYW
双福	SFW
双岗	OGT
双河口	SHW
双河镇	SEL
双吉	SML
双建	OJD
双流	ORW
双龙	SLY
双龙山	OIB
双蒙	SMZ
双庙子	SMT
双牌	SBZ
双泡子	OPD
双桥	SQP
双山屯	SPD
双石桥	SUW
双水	SLW
双堂	STA
双望	OQP
双溪	OOW
双鸭山	SSB
双羊店	SYD
双子河	SEB
水车湾	SWJ
水城	OCW
水地	OVD
水洞	SIL
水富	OTW
水沟	SEY
水花	SGW
水家湖	SQH
水江	ONW
水礼	SUL
水帘洞	SDL
水磨河	OVN
水曲柳	SQL
水泉	SID
水洋	SIP
水冶	SEF
水源	OYJ
顺昌	SCS
顺德	ORQ
顺德学院	OJQ
顺河场	SCW
顺义	SOP
朔州	SUV
朔州西	SXV
四道沟	SDD
四道湾	OUD
四方	SFK
四方台	STB
四分地	SFD
四分滩	SFC
四合	OED
四合台	OTD
四合屯	OHT
四合永	OHD
泗洪	GQH
司家岭	QLK
四家子	SXD
四井子	SGD
四棵树	SIR
四老沟	SLI
四马架	SMB
思	OMW
四平	SPT
四平东	PPT
泗水	OSK
四台子	OTT
思甜	SNR
泗亭	STZ
四团	STH
泗县	GPH
泗阳	MPH
宋	SOB
松坝	OBW
松河	SBM
松江	SAH
松江河	SJL
松江南	IMH
松江镇	OZL
松坎	OKW
松林	SIM
松林店	SDP
松岭	SWL
松青	OBB
松树	SFT
松树村	SUT
松树林	SXX
松树坡	SOY
松树台	IST
松树镇	SSL
松桃	MZQ
松原	VYT
宋寨	SNF
松滋	SIN
苏坂	SBS
苏北	OBT
苏宏图	SKC
苏集	SJC
苏家坡	SDY
苏家屯	SXT
肃宁	SYP
宿松	OAH
苏雄	OEW
苏州	SZH
宿州	OXH
苏州北	OHH
宿州东	SRH
苏州新区	ITH
苏州园区	KAH
算王庄	SVF
绥德	ODY
绥芬河	SFB
绥化	SHB
绥棱	SIB
遂宁	NIW
遂宁南	OHW
遂平	SON
绥西	SXB
遂溪	SXZ
绥阳	SYB
绥中	SZD
绥中北	SND
随州	SZN
孙家	SUB
孙吴	SKB
孙镇	OZY
索伦	SNT
索图罕	SHX
塔哈	THX
塔河	TXX
塔虎城	TMT
塔拉哈尔	TLC
塔力根土	TOD
塔前	TQG
塔山	TSD
他石海	TRT
塔石咀	TIM
塔崖驿	TYP
塔源	TWX
台安	TID
泰安	TMK
太白	TIW
泰达	TDA
台阁牧	TMC
太谷	TGV
太和	TUW
泰和	THG
太洪	TYW
太湖	TKH
台集屯	TTD
泰康	TKX
泰来	TLX
太岭	TNB
太姥山	TLS
泰宁	TNS
太平川	TIT
太平岭	TLL
太平桥	TPB
太平镇	TEB
太平庄	TPD
台前	TTK
苔青	TQB
台曲	TQV
泰山	TAK
太山所	PBQ
太阳村	TYZ
太阳沟	TYX
太阳山	TYJ
太阳升	TQT
太要	YEF
太原	TYV
太原北	TBV
太原东	TDV
太原西	TXV
台州	TZH
泰州	UTH
太子河	THT
郯城	TZK
坦甸	TDE
潭岗	TGG
覃家坝	QTW
谭家井	TNJ
口	TKS
滩头	TTW
滩头湾	TAQ
坦途	TTT
弹音	TEP
谭庄	TRN
塘豹	TBQ
汤池	TCX
塘渡口	TGQ
唐坊	TFP
唐房村	TFM
塘沽	TGP
塘沽南	TNP
唐官屯	TUP
棠海	THM
汤河	VTT
唐河	THF
唐家	TJD
唐家沱	KOW
唐家湾	PDQ
塘口	TKZ
塘库	TUZ
唐山	TSP
唐山北	FUP
汤山城	TCT
唐山东	THP
唐山南	TKP
汤头沟	TGD
塘头厦	TTQ
汤旺河	THB
唐王山	TWT
汤逊湖	THN
汤阴	TYF
汤原	TYB
桃村	TCK
桃村东	TDK
桃儿湾	TWC
陶家沟	TJW
陶家屯	TOT
陶赖昭	TPT
洮南	TVT
桃山	TAB
陶思浩	TSC
桃杏	TNV
桃映	TKQ
桃园	TYD
塔尔根	TRX
塔尔气	TVX
腾桥	TAG
藤县	TAZ
滕州	TXK
滕州东	TEK
天德	TDL
天德泉	TRL
田丁	TEZ
田东	TDZ
天鹅湖	TEC
天府北	TFW
天岗	TGL
天合	TTL
天湖	THR
天回镇	THW
田家沟	TQD
天津	TJP
天津北	TBP
天津南	TIP
天津西	TXP
天峻	TIO
田梁子	TAW
田林	TFZ
天门	TMN
天门南	TNN
天桥	VQT
天桥沟	VGT
天桥岭	TQL
天生桥	TSM
田师府	TFT
天水	TSJ
天台	TOW
天堂	TEQ
天通庵	TTA
天西	TXZ
田阳	TRZ
天义	TND
天镇	TZV
天祝	TZJ
天柱山	QWH
田庄	TWP
田庄镇	TZY
条子河	TZT
铁背山	TET
铁厂	TCL
铁佛寺	TBT
铁口	TKW
铁力	TLB
铁岭	TLT
铁岭西	PXT
铁山	TSN
铁西	TXW
亭亮	TIZ
亭林	TVH
亭子山	EFH
到保	RBT
陶卜齐	TBC
土贵乌拉	TGC
托克逊	TKR
土牧尔台	TRC
通安驿	TAJ
桐柏	TBF
通北	TBB
桐城	TTH
通道	TRQ
铜佛寺	TSL
通沟	TOL
铜鼓溪	TPW
潼关	TGY
铜罐驿	TGW
通海	TAM
通化	THL
通化县	TXL
佟家	VJT
佟家店	TDT
统军庄	TZP
通辽	TLD
通辽北	TED
通辽东	TDD
通辽西	TXD
铜陵	TJH
铜陵西	TLH
桐木寨	TMW
潼南	TVW
铜仁	RDQ
铜山	TRH
通天屯	TTB
通途	TUT
桐乡	TCH
同心	TXJ
通远堡	TYT
通州西	TAP
桐梓	TZW
桐子林	TEW
桃司兔	TTC
头道井	TJC
头道桥	TDC
头堡	TBR
土地堂东	TTN
图呼木	THC
土坎	TWW
图克木庙	TKC
图里河	TEX
吐列毛杜	TMD
图们	TML
土们岭	TNL
土门子	TCJ
土木	TMP
图强	TQX
土桥子	TQJ
土溪	TSW
团风	VFN
团结	TIX
团结村	TQW
团林	TUL
团山	TNT
屯升	TUJ
拖船埠	TFG
托托	TTR
沱沱河	THO
驼腰岭	TIL
吐鲁番	TFR
乌拉泊	WLR
乌兰哈达	WLC
乌兰浩特	WWT
乌兰花	WHC
乌拉特前旗	WQC
乌鲁木齐	WMR
乌苏	WSR
瓦房	WAD
瓦房店	WDT
瓦房店西	WXT
瓦拉干	WVX
洼里	WLP
挖色	WEM
瓦屋山	WAH
瓦窑坝	WCC
瓦窑堡	WOY
瓦窑田	WIM
瓦祖	WOW
歪头山	WIT
外洋	WYS
万安	WAV
弯道	WDX
万发屯	WFB
完工	WOX
湾沟	WGL
弯集	WJI
万家屯	WJD
万乐	WEB
万隆	WLL
万年	WWG
万宁	WNQ
弯w	WQW
万盛	WSW
万水泉	WAC
万水泉南	WNC
完县	WXP
万源	WYY
万州	WYW
万庄	WZP
王安镇	WVP
望布	WER
旺苍	WEW
王场	WCW
望城	WCQ
汪甸	WVZ
望都	WDP
王府	WUT
王岗	WGB
王官人屯	WGV
网户	WUD
王家坝	WDW
王家井	WIP
王家湾	WJJ
王家营	WJM
王家营西	KNM
王家寨	WIV
望江	WJB
王楼	WSH
王平村	WPP
汪清	WQL
望山	WVD
王瞳	WTP
王团庄	WZJ
望溪	WFW
王杨	WYB
王玉庄	WGP
王兆屯	WZB
王庄	WZF
卫东	WVT
潍坊	WFK
威海	WKK
苇河	WHB
威虎岭	WHL
卫辉	WHF
魏家沟	WJA
魏家楼	WEY
渭津	WJL
威箐	WAM
威岭	WNB
渭南	WNY
渭南北	WBY
渭南南	WVY
渭南镇	WNJ
威宁	WNT
魏善庄	WSP
威舍	WSM
苇塘	WTL
卫星	WVB
尾亚	WYR
魏杖子	WKD
韦庄	WZY
苇子沟	WZL
微子镇	WQP
文安	WBP
文昌	WEQ
温春	WDB
文登	WBK
文地	WNZ
温都和硕	WDC
文阁	WHM
温根托海	WTX
文官屯	WTT
温家圳	WJG
温岭	VHH
温泉	WQM
温泉寺	WQT
文水	WEV
闻喜	WXV
温州	RZH
温州南	VRH
文竹	WVG
文庄村	WOF
沃博尔	WEC
卧虎屯	WOD
倭肯	WQB
卧里屯	WLX
卧龙寺	WLY
卧牛河	WNX
沃皮	WPT
武安	WAP
务本	WBL
五叉沟	WCT
吴场	WUW
五常	WCB
武昌	WCN
武昌北	WBN
武昌东	WDN
武昌南	WNN
吴川	WAQ
五大连池	WRB
武当山	WRN
五道沟	WDL
五道河	WHP
五道木	WMD
武店	WUH
五峰	WFD
五凤溪	WXW
武功	WGY
五公里	WGK
乌固诺尔	WGX
吴官田	WGM
乌海	WVC
乌海北	WBC
乌海西	WXC
武汉	WHN
武汉北	WZN
芜湖	WHH
芜湖北	WBH
午汲	WJP
五家	WUB
吴家川	WCJ
五家户	WOT
吴家屯	WJT
乌江	WJW
五棵树	WKT
乌拉山	WSC
乌兰	WIO
乌兰胡同	WUC
乌兰基	WLD
乌兰木伦	WMC
乌兰丘	WQX
乌兰乌苏	WWR
乌兰昭	WZX
乌兰中	WZD
五里墩	WLG
五莲	WLK
五林	WLB
武隆	WLW
五龙背	WBT
乌龙泉东	WQN
乌龙泉南	WFN
乌鲁布铁	WBX
五女山	WET
吴堡	WUY
五七	WQD
五桥	WPW
吴桥	WUP
武清	WWP
乌日根塔拉	WRC
乌日图	WTC
五三	WST
武山	WSJ
五十家子	VZD
乌斯台	WID
乌斯土	WSD
五台山	WSV
吴圩	WYZ
武威	WUJ
武威南	WWJ
五五	WVR
乌西	WXR
无锡	WXH
无锡东	WGH
无锡新区	IFH
武乡	WVV
五象南	WEZ
武穴	WXN
武义	RYH
乌伊岭	WPB
武夷山	WAS
五营	WWB
五原	WYC
五寨	WZV
梧州	WZZ
梧州南	WBZ
西安	XAY
西安北	EAY
西安东	XDY
西安南	CAY
西八里	XLP
西柏坡	XBA
西拨子	XBP
西昌	ECW
西昌北	EEW
西昌南	ENW
西川	XCL
西村	XCG
西大庙	XMP
西大滩	XAJ
西道口	IUP
喜德	EDW
溪洞	XDL
西斗铺	XPC
息烽	XFW
西丰	XFT
西岗子	NBB
西沟	XGY
西固城	XUJ
西韩岭	XIV
西贺村	XHV
西河村	EHN
西胡尔清	XRC
西江	XEG
西街口	EKM
西口	XKT
西里	XIC
西丽	ELQ
西辽河	XID
西林	XYB
锡林浩特	XTC
锡林呼都嘎	XLC
西岭口	XKX
西刘	XBD
西柳	GCT
西六方	XFD
西麻山	XMB
西南杖子	XGD
西宁	XNO
西宁北	XKO
西宁西	XXO
西平	XPN
西陂	XPS
犀浦	XIW
犀浦东	XAW
喜鹊乐	ELM
西社	XTY
西石门	XVP
浠水	XZN
西索木	XOX
锡铁山	XRO
西桐古	XGK
西土城	XUC
西洼	XWD
西湾堡	XWV
西武匠	XMF
西峡	XIF
息县	ENN
西乡	XQY
西小沟	XXC
西小召	XZC
西阳	XYL
西阳岔	XIL
西阳村	XQF
西洋	XYS
西阳苑	EYP
西营门	EOP
西斋	XVN
西张	XRV
西张庄	XZV
西哲里木	XRD
汐子	XZD
夏坝	XBW
下板城	EBP
下仓	ECP
下城子	XCB
下初	XFK
夏官营	XGJ
下河	VHP
下花园	XYP
夏集	XGF
夏家河	XHT
下夹河所	XET
峡江	EJG
下坑子	XKC
峡口	XKR
夏拉哈马	XMC
下两	ERW
下马塘	XAT
夏茂	XFS
厦门	XMS
厦门北	XKS
厦门高崎	XBS
霞浦	XOS
下普雄	XPW
下社	XSV
夏石	XIZ
下太和	EAW
下台子	EIP
下塘	XOZ
下藤桥	XKW
夏小堡	XTV
下辛店	XDN
下新光	XXR
夏邑县	EJH
下峪口	XKY
仙村	XCQ
仙林	XPH
咸宁	XNN
咸宁北	XRN
咸宁东	XKN
咸宁南	UNN
仙人桥	XRL
仙水	EXW
鲜滩	XTW
仙桃西	XAN
咸阳	XYY
咸阳秦都	XOY
项城	ERN
香坊	XFB
襄汾	XFV
襄河	XXB
向隍	XZM
香兰	XNB
响沙湾	XSC
向韶	XVQ
湘潭	XTQ
向塘	XTG
向塘西	XXG
湘乡	XXQ
襄阳	XFN
向阳	XDB
襄阳北	XBN
向阳川	ECB
向阳村	XJX
向阳店	XYV
襄阳东	XWN
向阳镇	XNY
襄垣	EIF
祥云	EXM
小白	XBB
小北	XBX
小城	XAL
小池	ERH
小池口	EKG
小村	XEM
小得江	EJM
小东	XOD
小董	XEZ
小儿坪	XUW
孝感	XGN
孝感北	XJN
小高	XGW
小姑家	XGL
小关溪	EGW
小海口	XOM
小浩	EHW
小合隆	XWT
小河沿	XYD
小河镇	EKY
小黑山	XIX
小花果	XHN
小箐	EQM
小康庄	XKP
小榄	EAQ
小梁山	XAD
小林	EIN
小岭	XLB
小路溪	XLM
小南	XNT
孝南	XNV
小南海	XHW
小南垭	XNW
小平房	XPD
小桥	XSW
孝泉	XQW
小泉东	XQR
小山	XSL
小哨	XAM
小市	XST
小水峪	VSP
小寺沟	ESP
小宋	XOF
小唐庄	ETP
小土古里	XTR
小屯	XTT
小屯街	XTF
孝西	XOV
小溪坝	XXW
小喜村	XCM
小西庄	XXP
小新街	XXM
小扬气	XYX
小雨谷	XHM
小榆树	XSX
小月旧	XFM
小寨坝	XZW
小舟	XRS
斜河涧	EEP
谢家	XJL
谢家坟	XFA
谢家镇	XMT
石拐	SGC
新艾里	XVD
新安	EAM
新安村	XCP
新安江	XGH
新安县	XAF
新安庄	XAC
新保安	XAP
新场	XOW
新城川	XLV
新城子	XCT
新绰源	XRX
新村	XCZ
新店子	EQP
新东孝	XXE
新都	XDW
新墩	XEN
信丰	EFG
新丰镇	XFY
新干	EGG
新高峰	XGX
新固镇	XQP
新海	XUM
新寒岭	XVT
新和	XIR
新河	EEH
新华	XHB
新化	EHQ
新华屯	XAX
新晃	XLQ
新会	EFQ
辛集	ENP
新江	XJM
新绛	XJV
新街	XJC
新津	XRW
新九站	XUL
新开	XKD
新乐	ELP
新李	XLJ
新立	XND
新立屯	XLD
新立镇	XGT
新凉	XVW
新林	XPX
新岭	XLT
新龙华	XLH
新萝村	XLW
新庙	EMT
新民	XMD
新民场	EQW
新南沟	XNX
新平坝	XMW
新坪田	XPM
新坡	XPP
新祺周	XOG
新桥	XQH
新桥铺	XQQ
新青	XQB
新邱	XQD
新泉	EQB
新市区	XNP
新松浦	XOB
新台子	XIT
新塘	XWQ
新塘边	XTH
新天	XXX
新铁村	XEW
新窝铺	EPD
新县	XSN
新贤城	XCC
新乡	XXF
新乡东	EGF
新香坊	XTB
新兴	XXL
新兴县	XGQ
新彦	EYX
信阳	XUN
信阳东	OYN
新阳镇	XZJ
新沂	VIH
信宜	EEQ
新沂西	XDK
新友谊	EYB
新余	XUG
新园	XUT
新站	XZL
新帐房	XZX
新杖子	ERP
新肇	XZT
新郑	XNF
新郑北	XBF
忻州	XXV
辛庄	EZP
莘庄	XZH
辛庄子	XIP
兴安	XAZ
兴安北	XDZ
兴安岭	XVX
兴城	XCD
兴福	XEB
幸福滩	XFR
兴国	EUG
兴和	XBC
兴和西	XEC
邢家堡	XJP
兴凯	EKB
星朗	ELW
兴莲	XGB
杏林	XLS
兴隆店	XDD
兴隆河	XIA
兴隆山	XLL
兴隆县	EXP
兴隆镇	XZB
兴南	SIV
兴宁	ENQ
兴平	XPY
兴泉堡	XQJ
兴寿	EVP
杏树	XSB
杏树岗	XSD
杏树屯	XDT
邢台	XTP
邢台东	EDP
兴无	XUX
荥阳南	XPF
星耀	XDC
兴业	FYZ
兴义	XRZ
星源	XNR
熊岳城	XYT
绣峰	XFX
秀山	ETW
修文	XUV
修武	XWF
许昌	XCF
许昌东	XVF
蓿D	XHC
胥各庄	EUP
墟沟	EZH
徐家	XJB
徐家坪	XJY
许家台	XTJ
许家屯	XJT
溆浦	EPQ
许三湾	XSJ
徐水	XSP
徐水东	EAP
徐闻	XJQ
徐州	XCH
徐州东	UUH
宣城	ECH
轩岗	XGV
宣汉	XHY
宣和	XWJ
宣化	XHP
宣家沟	XUD
宣威	XWM
悬钟	XRP
薛家	XJD
雪门寺	ESW
学庄	EZW
巡场	XJW
寻甸	XMM
旬阳	XUY
旬阳北	XBY
亚布力	YBB
亚布力南	YWB
亚复	YRL
亚沟	YGB
亚河	YHB
雅河	YLT
鸭江	ACW
牙克石	YKX
垭口	YKW
牙拉盖图	YTC
亚龙湾	TWQ
雅鲁	YYX
衙门庙	YMC
衙门营	YMD
鸦雀岭	YLN
牙屯堡	YTZ
鸭园	YYL
雅子泉	YQR
延安	YWY
盐城	AFH
晏城	YEK
晏城北	YYK
盐池	YKJ
雁翅	YAP
砚川	YYY
雁荡山	YGH
盐岛	YNT
烟灯吐	YDD
烟墩	YDR
雁儿崖	YEA
炎方	YEM
燕岗	YGW
严关乡	YXZ
沿河城	YHP
盐湖	YHR
岩会	AEP
延吉	YJL
阎家	YIB
晏家坝	YBY
燕家庄	AZK
燕郊	AJP
岩脚寨	YWW
延津	YOF
盐津	AEW
盐津北	KCW
阎良	YNY
燕落	YLP
焉耆	YSR
延庆	YNP
延庆北	YDV
延庆南	YQA
盐泉	YCR
岩山	YNX
燕山	AOP
铅山西	QSA
偃师	YSF
雁石	YSS
烟台	YAK
烟台北	ATK
烟筒山	YSL
烟筒屯	YUX
燕舞	YRD
雁西湖	YCP
沿寨	AZV
兖州	YZK
燕子砭	YZY
燕子洞	YPM
羊草	YAB
秧草地	YKM
阳岔	YAL
羊场	YED
阳城	YNF
阳澄湖	AIH
羊城铁旅	YCA
阳春	YQQ
杨村	YBP
阳方口	YFV
杨岗	YRB
阳高	YOV
杨各庄	AGP
阳谷	YIK
洋河	GTH
扬嘉	YRW
杨家	YJB
杨家店	YJD
杨家粉坊	YFT
杨家口	AKP
杨家岭	YLG
杨家湾	YJY
杨家营	AVD
羊臼河	YHM
阳朗	YNW
杨林	YLM
杨陵南	YEY
杨陵镇	YSY
杨柳青	YQP
养龙司	YVW
养马河	YAW
阳明堡	YVV
杨木	YMB
羊坪	APW
阳平关	YAY
阳平关东	YKY
羊堡	ABM
阳曲	YQV
阳泉	AQP
阳泉北	YPP
阳泉曲	YYV
羊圈子	YQD
阳山	YIT
杨树岭	YAD
杨树湾	YCD
羊尾哨	YWM
杨溪	YXG
洋县	YVY
阳新	YON
杨辛庄	YXP
杨漩	YYW
阳邑	ARP
阳原	YAV
杨杖子	YZD
羊者窝	AEM
扬州	YLH
姚安	YAC
窑村	YCY
姚家	YAT
姚家坨子	YTT
姚家洲	YZG
遥林	YLL
姚堡	YPD
姚千户屯	YQT
窑上	ASP
腰栈	YVD
叶柏寿	YBD
叶城	YER
叶集	YCH
野马寨	AVW
叶茂	YMZ
野三坡	AIP
野溪	YWP
叶榭	YOH
英吉沙	YIR
依安	YAX
宜宾	YBW
宜宾南	ANW
一步滩	YIW
宜昌	YCN
宜昌东	HAN
宜城	YIN
伊川	YCF
伊春	YCB
宜春	YCG
伊尔施	YET
伊和恩格拉	YNC
义合镇	AIY
一间堡	YJT
义井	YOP
易坑	YES
益口	YKS
伊拉哈	YLX
彝良	ALW
宜良北	YSM
彝良南	RFW
伊林	YLB
义马	YMF
伊吗图	YTD
一面坡	YPB
一面山	YST
伊敏	YMX
伊敏索木	YOX
迤那	AKW
宜耐	YVM
沂南	YNK
伊宁	YMR
伊宁东	YNR
一平浪	YIM
义卜寨	AZP
沂水	YUK
一四二公里	YEC
伊图里河	YEX
义乌	YWH
义县	YXD
宜兴	YUH
益阳	AEQ
宜阳	YYF
弋阳东	YIG
益阳东	ADQ
仪征	UZH
宜州	YSZ
亦庄	YUP
迤资	YQM
银阿	YCX
银城铺	APP
银川	YIJ
银川南	YEJ
尹地	YDM
殷家河	VHN
银浪	YJX
饮马河	YHL
饮马峡	YRO
阴塔	ANV
银镇	AZD
营北	YGD
影壁山	YBA
迎宾路	YFW
应城	YHN
营城	YCL
营城子	YCT
颖川堡	YCJ
迎春	YYB
英德	YDQ
英德西	IIQ
营东	IDT
英额门	YML
莺歌	YOD
营街	YAM
营口	YKT
营口东	YGT
营盘	YPT
营盘上	YBG
营盘水	YZJ
营盘湾	YPC
营山	NUW
颍上	YVH
硬石岭	YRG
鹰手营子	YIP
迎水桥	YQJ
鹰潭	YTG
迎祥街	YJW
营镇	YTY
永安	YAS
永安乡	YNB
永昌	YDH
永川	YCW
永登	YDJ
永甸	INT
永定	YGS
永丰营	YYM
永福	YFZ
永福南	YBZ
永和	YEP
永红	YOL
永济	YIV
永嘉	URH
永嘉堡	YJV
永康	RFH
永郎	YLW
永乐	YEZ
永乐店	YDY
永宁	YEL
邕宁	YRZ
永宁镇	YNH
永平	YVG
永庆	YVX
永胜	YVB
永泰	YTS
永王庄	YWC
永兴	YDW
永修	ACG
永州	AOQ
永州东	YDE
友好	YOB
油溪	YXW
尤溪	YXS
攸县	YOG
酉阳	AFW
友谊水库	YSC
幽州	YZP
犹字井	YOT
渔坝村	YBM
鱼背山	YMW
禹城	YCK
虞城县	IXH
俞冲	YUW
榆次	YCV
鱼洞	YOM
玉洞	YDZ
于都	YDG
鱼儿沟	YGR
雨格	VTM
榆关	AMP
于官屯	YGK
于海屯	YBT
余杭	EVH
余家湾	YWN
于家庄	YRP
余江	YHG
渔津庄	YJP
余粮堡	YLD
榆林	ALY
玉林	YLZ
玉门	YXJ
玉门东	YMJ
玉门沟	YMV
禹门口	YKV
裕民	AMW
玉屏	YZW
鱼泉	AYW
玉泉	YQB
玉山	YNG
郁山	KSW
榆社	YSV
玉舍	AUM
玉石	YSJ
榆树	YRT
榆树川	YNL
榆树沟	YGP
榆树台	YUT
榆树屯	YSX
玉田北	YBV
玉田县	ATP
玉溪	YXM
裕溪口	YXH
裕溪口东	YKH
玉溪南	YRM
育新	YID
余姚	YYH
余姚北	CTH
宇宙地	YZC
鱼嘴	AUW
元坝	YOW
元宝山	YUD
袁北	WNH
园墩	YAJ
袁家堡	IVT
原林	YWX
元龙	YLY
元谋	YMM
原平	YPV
原平南	YPA
源迁	AQK
元氏	YSP
袁树林	YLV
源潭	YTQ
元田坝	YPW
鸳鸯镇	YYJ
袁寨	YRH
月池台	YUY
月华	YQW
岳家井	YGJ
月亮田	YUM
乐清	UPH
月山	YBF
越西	YHW
岳阳	YYQ
岳阳东	YIQ
云彩岭	ACP
运城	YNV
郓城	YPK
云端	YND
云岗	YGV
云居寺	AFP
云梦	YMN
云台山	UQH
云田乡	YTJ
云霄	YBS
蕴藻浜	YZA
昝各庄	JEP
皂角铺	ZPW
枣林	ZIV
枣强	ZVP
枣窝	ZOJ
早阳	ZAY
枣阳	ZYN
枣园	ZYK
枣庄	ZEK
枣庄西	ZFK
枣子林	ZEW
泽普	ZPR
泽润里	ZLM
曾家坪子	ZBW
缯溪河	ZXY
闸河	ZOH
扎兰屯	ZTX
扎鲁特	ZLD
扎罗木得	ZMX
柞水	ZSY
扎音河	ZYB
渣泽	ZZH
咋子	ZAL
扎佐	ZOW
寨口	ZEP
寨隆	ZLZ
寨西店	ZFP
湛江	ZJZ
湛江北	ZBZ
湛江西	ZWQ
占杨	ZEF
沾益	ZYM
张百湾	ZUP
章村	ZWP
章党	ZHT
张坊	ZFG
章古台	ZGD
张贵庄	ZZP
张华浜	ZHA
张集	VJH
张家船	ZBY
张家祠	ZCJ
张家界	DIQ
张家界北	ZNQ
张家口	ZKP
张家口南	ZMP
张家堡	ZBT
张家山	ZJG
张家庄	ZJP
张兰	ZLV
樟林	ZLS
张茅	ZOF
张庙	VMH
樟木头	ZOQ
漳平	ZPS
漳浦	ZCS
张桥	ZQY
章丘	ZTK
张三营	ZSD
樟树	ZSG
樟树东	ZOG
樟树潭	ZTH
张台子	ZZT
丈亭	ZIH
张王庙	ZWG
张维屯	ZWB
彰武	ZWD
张夏	ZXK
张巷	ZYG
张辛	ZIP
张掖	ZYJ
张寨	ZHI
漳州	ZUS
漳州东	GOS
漳州北	ZZS
诏安	ZDS
招柏	ZBP
赵城	ZCV
赵川	ZCP
照东	ZDR
肇东	ZDB
照福铺	ZFM
赵光	ZGB
昭化	ZHW
赵家	ZJB
赵家沟	ZJT
赵家水	ZSJ
赵家窑	ZIJ
肇庆	ZVQ
昭通	ZDW
昭通北	ZCW
昭通南	ZFW
赵庄	ZUF
哲里木	ZLC
镇安	ZEY
镇城底	ZDV
振德	ZAT
镇江	ZJH
镇江南	ZEH
镇赉	ZLT
镇罗堡	ZLJ
镇平	ZPF
枕头峰	ZTL
轸溪	ZQW
镇西	ZVT
镇远	ZUW
珍珠门	ZZL
镇紫街	ZJW
正定	ZDP
正定机场	ZHP
郑集	ZJI
郑家堡	ZPL
郑家屯	ZJD
郑屯	ZTZ
正镶白旗	ZXC
正仪	ZYH
郑州	ZZF
郑州北	ZBF
郑州东	ZAF
郑州西	ZXF
治安	ZAD
枝城	ZCN
轵城	ZCF
纸坊东	ZMN
枝江北	ZIN
芷江西	ZXQ
织金	IZW
芝兰庄	ZMK
治山	ZSB
峙滩	SSG
中村	ZCG
中德	ZDT
忠工屯	ZOX
中和	ZHX
中华门	VNH
中华寺	ZNT
钟家村	ZJY
中牟	ZGF
中宁	VNJ
中宁东	ZDJ
中宁南	ZNJ
中堡	ZBJ
中山	ZSQ
钟山	ZSZ
中山北	ZGQ
中台子	ZVD
中滩	HOM
中卫	ZWJ
中仙	ZBS
钟祥	ZTN
中小所	ZOT
中心	ZRW
中兴	ZXT
中谊村	ZIM
中寨	ZZM
钟杖子	ZZD
中嘴	EUW
洲湖	ZIG
周家	ZOB
周家屯	ZOD
周家寨	ZUQ
周泾巷	ZUH
周口	ZKN
周口店	ZPP
周曲家	ZBH
周士庄	ZSV
周水子	ZIT
周铁岗	ZZN
周王庙	VWH
朱保	VBK
珠宝岗	ZBL
诸城	ZQK
朱店	ZBN
竹峰	VFH
朱嘎	RKW
朱各庄	ZGP
珠海	ZHQ
珠海北	ZIQ
诸暨	ZDH
珠玑	ZJK
朱家沟	ZUB
朱家坑	ZKG
朱家窑	ZUJ
朱刘店	ZLK
驻马店	ZDN
驻马店西	ZLN
珠日河牧场	ZRD
朱三家	ZTT
珠山	ZRG
朱石寨	ZVW
珠斯花	ZHD
珠亭山	ZHG
诸往	DWK
珠窝	ZOP
朱杨溪	ZXW
竹园坝	ZAW
朱杖子	ZUD
株洲	ZZQ
株洲北	ZBQ
株洲西	ZAQ
朱庄	ZAK
转关口	ZKW
转龙湾	ZWC
庄河	ZET
庄桥	ZQH
庄头	ZSP
壮志	ZUX
准沙日乌苏	ZSC
濯港	ZKH
涿鹿	ZUV
涿州	ZXP
涿州东	ZAP
卓资东	ZDC
卓资山	ZZC
淄博	ZBK
子长	ZHY
淄川	ZWK
自贡	ZGW
自贡南	ZWW
紫沟	ZGX
紫荆关	ZYP
梓潼	KRW
资溪	ZXS
紫溪	ZXZ
资阳	ZYW
紫阳	ZVY
紫寨	ZZV
资中	ZZW
子洲	ZZY
棕溪	ZOY
邹城	ZIK
走马岭	ZLW
遵化	ZQP
遵化北	ZBV
遵化南	ZTP
遵义	ZIW
遵义北	DGW
遵义南	ZNW
左港	ZGG
左家	ZJL
